//MAP CONVERTED BY dmm2tgm.py THIS HEADER COMMENT PREVENTS RECONVERSION, DO NOT REMOVE
"a" = (
/turf/open/floor/iron,
/area/station/cargo/exploration_office)
"g" = (
/obj/effect/turf_decal/trimline/brown/filled/line{
	dir = 4
	},
/turf/open/floor/iron,
/area/station/cargo/exploration_office)
"h" = (
/obj/effect/spawner/structure/window/reinforced,
/turf/open/floor/plating,
/area/station/cargo/exploration_office)
"j" = (
/obj/effect/turf_decal/trimline/brown/filled/line{
	dir = 9
	},
/turf/open/floor/iron,
/area/station/cargo/exploration_office)
"m" = (
/turf/template_noop,
/area/template_noop)
"o" = (
/obj/effect/turf_decal/tile/brown/opposingcorners,
/obj/effect/landmark/navigate_destination/exploration_office,
/turf/open/floor/iron,
/area/station/cargo/exploration_office)
"v" = (
/turf/open/floor/engine,
/area/station/cargo/exploration_office)
"y" = (
/obj/machinery/atmospherics/components/unary/vent_pump/on/layer4,
/obj/effect/turf_decal/trimline/brown/filled/line{
	dir = 5
	},
/obj/structure/cable,
/obj/machinery/power/apc/auto_name/directional/north,
/turf/open/floor/iron,
/area/station/cargo/drone_bay)
"z" = (
/obj/effect/turf_decal/trimline/brown/filled/line{
	dir = 1
	},
/turf/open/floor/iron,
/area/station/cargo/exploration_office)
"A" = (
/obj/machinery/door/airlock/public/glass{
	name = "Exploration Office Inner Chamber"
	},
/turf/open/floor/engine,
/area/station/cargo/exploration_office)
"B" = (
/obj/effect/turf_decal/trimline/brown/filled/line{
	dir = 6
	},
/turf/open/floor/iron,
/area/station/cargo/exploration_office)
"D" = (
/turf/closed/wall,
/area/station/cargo/exploration_office)
"I" = (
/turf/open/floor/plating,
/area/station/cargo/exploration_office)
"L" = (
/obj/machinery/light/directional/south,
/turf/open/floor/engine,
/area/station/cargo/exploration_office)
"M" = (
/obj/effect/turf_decal/trimline/brown/filled/line{
	dir = 10
	},
/turf/open/floor/iron,
/area/station/cargo/exploration_office)
"O" = (
/obj/machinery/dive_anchor/stationary,
/turf/open/floor/engine,
/area/station/cargo/exploration_office)
"S" = (
/obj/effect/turf_decal/trimline/brown/filled/line{
	dir = 5
	},
/turf/open/floor/iron,
/area/station/cargo/exploration_office)
"T" = (
/obj/effect/turf_decal/trimline/brown/filled/line,
/turf/open/floor/iron,
/area/station/cargo/exploration_office)
"V" = (
/obj/effect/turf_decal/trimline/brown/filled/line{
	dir = 9
	},
/obj/machinery/light_switch/directional/west{
	pixel_x = -22;
	pixel_y = -8
	},
/obj/structure/cable,
/turf/open/floor/iron,
/area/station/cargo/drone_bay)
"X" = (
/obj/effect/turf_decal/trimline/brown/filled/line{
	dir = 8
	},
/turf/open/floor/iron,
/area/station/cargo/exploration_office)
"Y" = (
/obj/effect/turf_decal/tile/brown/opposingcorners,
/turf/open/floor/iron,
/area/station/cargo/exploration_office)

(1,1,1) = {"
D
D
D
D
D
D
D
D
D
D
D
D
D
D
D
m
m
"}
(2,1,1) = {"
D
j
X
X
X
X
X
X
M
Y
Y
Y
Y
Y
Y
o
V
"}
(3,1,1) = {"
D
z
a
a
a
a
a
a
T
D
D
h
h
h
D
m
y
"}
(4,1,1) = {"
D
z
a
a
a
a
a
a
T
D
m
m
m
m
m
m
m
"}
(5,1,1) = {"
D
z
a
a
a
a
a
a
T
D
m
m
m
m
m
m
m
"}
(6,1,1) = {"
D
z
a
a
a
a
a
a
T
D
m
m
m
m
m
m
m
"}
(7,1,1) = {"
D
z
a
a
a
a
a
a
T
D
m
m
m
m
m
m
m
"}
(8,1,1) = {"
D
S
g
g
g
g
g
g
B
D
m
m
m
m
m
m
m
"}
(9,1,1) = {"
D
D
A
D
D
I
D
D
D
D
m
m
m
m
m
m
m
"}
(10,1,1) = {"
h
v
v
v
D
I
D
m
m
m
m
m
m
m
m
m
m
"}
(11,1,1) = {"
h
v
O
L
D
I
D
m
m
m
m
m
m
m
m
m
m
"}
(12,1,1) = {"
h
v
v
v
D
m
m
m
m
m
m
m
m
m
m
m
m
"}
(13,1,1) = {"
h
h
h
h
D
m
m
m
m
m
m
m
m
m
m
m
m
"}
