//MAP CONVERTED BY dmm2tgm.py THIS HEADER COMMENT PREVENTS RECONVERSION, DO NOT REMOVE
"as" = (
/obj/effect/spawner/random/engineering/tracking_beacon,
/turf/open/floor/iron,
/area/station/cargo/exploration_office)
"aA" = (
/obj/machinery/atmospherics/pipe/smart/manifold4w/supply/hidden/layer4,
/obj/machinery/atmospherics/pipe/smart/manifold4w/scrubbers/hidden/layer2,
/obj/effect/turf_decal/trimline/brown/filled/line{
	dir = 6
	},
/obj/structure/closet/mini_fridge,
/obj/effect/spawner/random/food_or_drink/refreshing_beverage,
/obj/effect/spawner/random/food_or_drink/refreshing_beverage,
/obj/effect/turf_decal/siding/dark{
	dir = 8
	},
/turf/open/floor/iron,
/area/station/cargo/exploration_office)
"ba" = (
/obj/effect/turf_decal/sand/plating,
/obj/structure/railing/corner/end,
/obj/structure/railing/corner/end/flip{
	dir = 1
	},
/turf/open/floor/plating/airless,
/area/station/asteroid)
"bv" = (
/obj/effect/spawner/structure/window/reinforced,
/turf/open/floor/plating,
/area/station/cargo/exploration_office)
"co" = (
/obj/effect/turf_decal/stripes/line{
	dir = 5
	},
/turf/open/floor/engine,
/area/station/cargo/exploration_office)
"cq" = (
/obj/structure/flora/rock/pile/style_random,
/turf/open/misc/asteroid/airless,
/area/station/asteroid)
"db" = (
/obj/effect/turf_decal/trimline/brown/filled/line{
	dir = 10
	},
/obj/machinery/atmospherics/pipe/smart/manifold4w/supply/hidden/layer4,
/obj/machinery/atmospherics/pipe/smart/manifold4w/scrubbers/hidden/layer2,
/obj/structure/cable,
/turf/open/floor/iron,
/area/station/cargo/exploration_office)
"dr" = (
/obj/effect/turf_decal/tile/brown/opposingcorners,
/obj/machinery/atmospherics/pipe/smart/manifold4w/supply/hidden/layer4,
/obj/machinery/atmospherics/pipe/smart/manifold4w/scrubbers/hidden/layer2,
/obj/structure/cable,
/obj/structure/sign/poster/official/there_is_no_gas_giant/directional/west,
/turf/open/floor/iron,
/area/station/cargo/exploration_office)
"ew" = (
/obj/effect/turf_decal/trimline/brown/filled/line{
	dir = 8
	},
/obj/item/kirbyplants/random{
	pixel_x = -7;
	pixel_y = 16
	},
/obj/machinery/firealarm/directional/west,
/turf/open/floor/iron,
/area/station/cargo/exploration_office)
"eC" = (
/obj/effect/landmark/start/explorer,
/obj/structure/chair{
	dir = 8
	},
/obj/effect/turf_decal/tile/brown/opposingcorners{
	dir = 8
	},
/turf/open/floor/iron/dark,
/area/station/cargo/exploration_office)
"gc" = (
/obj/effect/turf_decal/sand/plating,
/obj/structure/railing/corner/end{
	dir = 4
	},
/obj/structure/railing/corner/end/flip{
	dir = 8
	},
/turf/open/floor/plating/airless,
/area/station/asteroid)
"gn" = (
/obj/effect/turf_decal/siding/dark/corner,
/obj/effect/decal/cleanable/dirt,
/turf/open/floor/iron,
/area/station/cargo/exploration_office)
"gH" = (
/obj/machinery/light/directional/south,
/obj/effect/turf_decal/stripes/line,
/obj/machinery/atmospherics/components/unary/vent_scrubber/on/layer2{
	dir = 8
	},
/turf/open/floor/engine,
/area/station/cargo/exploration_office)
"hn" = (
/obj/effect/turf_decal/trimline/brown/filled/line{
	dir = 1
	},
/obj/structure/table,
/obj/item/reagent_containers/cup/glass/mug{
	pixel_x = -7;
	list_reagents = list(/datum/reagent/consumable/coffee = 10)
	},
/obj/item/paper_bin{
	pixel_x = 7;
	pixel_y = 4
	},
/obj/item/pen,
/turf/open/floor/iron,
/area/station/cargo/exploration_office)
"hq" = (
/obj/effect/turf_decal/stripes/line{
	dir = 10
	},
/obj/machinery/atmospherics/pipe/smart/manifold4w/scrubbers/hidden/layer2,
/obj/effect/decal/cleanable/vomit/old,
/turf/open/floor/engine,
/area/station/cargo/exploration_office)
"hJ" = (
/obj/machinery/dive_anchor,
/turf/open/space/openspace,
/area/space/nearstation)
"is" = (
/obj/effect/decal/cleanable/rubble,
/turf/open/misc/asteroid/airless,
/area/station/asteroid)
"iH" = (
/obj/structure/chair/office{
	dir = 4
	},
/obj/effect/landmark/start/explorer,
/turf/open/floor/iron,
/area/station/cargo/exploration_office)
"iP" = (
/obj/structure/tank_dispenser/oxygen,
/obj/effect/turf_decal/tile/brown/fourcorners,
/obj/structure/sign/poster/official/safety_internals/directional/west,
/turf/open/floor/iron,
/area/station/cargo/exploration_office)
"jg" = (
/obj/effect/turf_decal/tile/brown/fourcorners,
/obj/item/storage/box/nri_flares{
	pixel_y = 3;
	pixel_x = -6
	},
/obj/machinery/recharger{
	pixel_x = 8;
	pixel_y = 3
	},
/obj/structure/table/reinforced,
/obj/structure/railing{
	dir = 4
	},
/turf/open/floor/iron,
/area/station/cargo/exploration_office)
"jD" = (
/obj/structure/sign/warning/directional/north,
/obj/structure/flora/rock/style_random,
/turf/open/misc/asteroid/airless,
/area/station/asteroid)
"li" = (
/obj/effect/turf_decal/trimline/brown/filled/line{
	dir = 4
	},
/obj/structure/sign/warning/directional/east,
/obj/machinery/atmospherics/pipe/smart/manifold4w/supply/hidden/layer4,
/obj/machinery/atmospherics/pipe/smart/manifold4w/scrubbers/hidden/layer2,
/turf/open/floor/iron,
/area/station/cargo/exploration_office)
"lv" = (
/obj/machinery/computer/anchor_controller{
	dir = 8
	},
/turf/open/floor/iron,
/area/station/cargo/exploration_office)
"mq" = (
/obj/effect/turf_decal/trimline/brown/filled/line,
/obj/machinery/camera/autoname/directional/south,
/obj/machinery/atmospherics/pipe/smart/manifold4w/supply/hidden/layer4,
/obj/machinery/atmospherics/pipe/smart/manifold4w/scrubbers/hidden/layer2,
/obj/structure/cable,
/turf/open/floor/iron,
/area/station/cargo/exploration_office)
"nn" = (
/obj/structure/rack,
/obj/item/trench_tool{
	pixel_x = 3;
	pixel_y = 2
	},
/obj/item/trench_tool{
	pixel_x = -1;
	pixel_y = 6
	},
/turf/open/floor/plating,
/area/station/cargo/exploration_office)
"nA" = (
/obj/effect/turf_decal/trimline/brown/filled/line{
	dir = 4
	},
/obj/machinery/atmospherics/pipe/smart/manifold4w/supply/hidden/layer4,
/obj/machinery/atmospherics/pipe/smart/manifold4w/scrubbers/hidden/layer2,
/obj/machinery/airalarm/directional/east,
/obj/effect/turf_decal/stripes/corner,
/turf/open/floor/iron,
/area/station/cargo/exploration_office)
"or" = (
/turf/open/floor/iron,
/area/station/cargo/exploration_office)
"oB" = (
/turf/template_noop,
/area/template_noop)
"oL" = (
/obj/effect/turf_decal/stripes/line{
	dir = 9
	},
/obj/machinery/camera/autoname/directional/west,
/obj/machinery/atmospherics/pipe/smart/manifold4w/supply/hidden/layer4,
/turf/open/floor/engine,
/area/station/cargo/exploration_office)
"pi" = (
/obj/effect/turf_decal/sand/plating,
/obj/structure/railing{
	dir = 6
	},
/obj/structure/marker_beacon/indigo{
	pixel_x = -12;
	pixel_y = 15
	},
/turf/open/floor/plating/airless,
/area/station/asteroid)
"pI" = (
/obj/effect/turf_decal/trimline/brown/filled/line,
/obj/machinery/atmospherics/pipe/smart/manifold4w/supply/hidden/layer4,
/obj/machinery/atmospherics/pipe/smart/manifold4w/scrubbers/hidden/layer2,
/obj/machinery/power/apc/auto_name/directional/south,
/obj/structure/cable,
/obj/effect/turf_decal/siding/dark{
	dir = 4
	},
/turf/open/floor/iron,
/area/station/cargo/exploration_office)
"qW" = (
/obj/structure/closet/toolcloset,
/obj/effect/turf_decal/tile/brown/fourcorners,
/obj/item/flashlight,
/obj/structure/railing{
	dir = 4
	},
/turf/open/floor/iron,
/area/station/cargo/exploration_office)
"ru" = (
/obj/effect/turf_decal/tile/brown/fourcorners,
/obj/machinery/portable_atmospherics/canister/oxygen,
/obj/effect/decal/cleanable/cobweb,
/turf/open/floor/iron,
/area/station/cargo/exploration_office)
"sn" = (
/obj/machinery/light/floor,
/obj/effect/landmark/start/explorer,
/turf/open/floor/iron/textured_large,
/area/station/cargo/exploration_office)
"sE" = (
/obj/effect/turf_decal/stripes/end{
	dir = 8
	},
/obj/effect/mapping_helpers/airlock/access/any/command/gateway,
/obj/machinery/door/airlock/external/glass{
	name = "Exploration Office Airlock"
	},
/obj/effect/mapping_helpers/airlock/cyclelink_helper{
	dir = 4
	},
/turf/open/floor/iron,
/area/station/cargo/exploration_office)
"th" = (
/obj/effect/turf_decal/sand/plating,
/obj/structure/railing{
	dir = 9
	},
/obj/structure/marker_beacon/indigo{
	pixel_x = 14;
	pixel_y = -12
	},
/turf/open/floor/plating/airless,
/area/station/asteroid)
"tB" = (
/obj/effect/turf_decal/tile/brown/fourcorners,
/obj/structure/table/reinforced,
/obj/machinery/cell_charger,
/turf/open/floor/iron,
/area/station/cargo/exploration_office)
"tP" = (
/obj/effect/turf_decal/trimline/brown/filled/line{
	dir = 1
	},
/obj/structure/closet/crate/bin,
/obj/effect/spawner/random/trash/garbage,
/obj/effect/spawner/random/trash/garbage,
/turf/open/floor/iron,
/area/station/cargo/exploration_office)
"tW" = (
/obj/effect/decal/cleanable/dirt,
/obj/effect/spawner/random/trash/food_packaging,
/turf/open/floor/iron,
/area/station/cargo/exploration_office)
"un" = (
/turf/closed/wall/mineral/iron,
/area/station/cargo/exploration_office)
"us" = (
/obj/effect/turf_decal/trimline/brown/filled/line{
	dir = 1
	},
/obj/item/kirbyplants/random{
	pixel_x = -7;
	pixel_y = 16
	},
/turf/open/floor/iron/textured_edge,
/area/station/cargo/exploration_office)
"uF" = (
/obj/effect/turf_decal/stripes/line{
	dir = 6
	},
/turf/open/floor/engine,
/area/station/cargo/exploration_office)
"xU" = (
/obj/effect/turf_decal/trimline/brown/filled/line{
	dir = 4
	},
/obj/machinery/atmospherics/pipe/smart/manifold4w/supply/hidden/layer4,
/obj/machinery/atmospherics/pipe/smart/manifold4w/scrubbers/hidden/layer2,
/turf/open/floor/iron,
/area/station/cargo/exploration_office)
"xX" = (
/obj/machinery/door/airlock/public/glass{
	name = "Exploration Office Inner Chamber"
	},
/obj/machinery/door/firedoor,
/obj/effect/mapping_helpers/airlock/access/any/command/gateway,
/obj/machinery/atmospherics/pipe/smart/manifold4w/supply/hidden/layer4,
/obj/machinery/atmospherics/pipe/smart/manifold4w/scrubbers/hidden/layer2,
/turf/open/floor/engine,
/area/station/cargo/exploration_office)
"ye" = (
/obj/item/grown/bananapeel{
	pixel_x = -4;
	pixel_y = 6
	},
/turf/open/misc/asteroid/airless,
/area/station/asteroid)
"zf" = (
/obj/structure/chair{
	dir = 4
	},
/obj/effect/turf_decal/tile/brown/opposingcorners{
	dir = 8
	},
/turf/open/floor/iron/dark,
/area/station/cargo/exploration_office)
"zo" = (
/obj/effect/turf_decal/sand/plating,
/obj/structure/railing{
	dir = 1
	},
/turf/open/floor/plating/airless,
/area/station/asteroid)
"Bi" = (
/obj/machinery/atmospherics/pipe/smart/manifold4w/supply/hidden/layer4,
/obj/machinery/atmospherics/pipe/smart/manifold4w/scrubbers/hidden/layer2,
/obj/effect/decal/cleanable/dirt,
/obj/structure/table,
/obj/item/reagent_containers/cup/glass/bottle/juice/smallcarton{
	pixel_x = -7;
	pixel_y = 6;
	list_reagents = list(/datum/reagent/consumable/tomatojuice = 15)
	},
/obj/item/radio/entertainment/speakers/physical{
	pixel_y = 1
	},
/obj/effect/turf_decal/tile/brown/opposingcorners{
	dir = 8
	},
/turf/open/floor/iron/dark,
/area/station/cargo/exploration_office)
"Bo" = (
/obj/machinery/atmospherics/pipe/smart/manifold4w/supply/hidden/layer4,
/obj/machinery/atmospherics/pipe/smart/manifold4w/scrubbers/hidden/layer2,
/obj/structure/chair{
	dir = 4
	},
/obj/effect/turf_decal/tile/brown/opposingcorners{
	dir = 8
	},
/turf/open/floor/iron/dark,
/area/station/cargo/exploration_office)
"Bx" = (
/obj/machinery/light/small/directional/west{
	pixel_x = 32
	},
/turf/closed/wall,
/area/station/cargo/exploration_office)
"Cv" = (
/obj/effect/decal/cleanable/dirt,
/obj/effect/turf_decal/siding/dark,
/turf/open/floor/iron,
/area/station/cargo/exploration_office)
"Ep" = (
/obj/machinery/atmospherics/pipe/smart/manifold4w/supply/hidden/layer4,
/obj/machinery/atmospherics/pipe/smart/manifold4w/scrubbers/hidden/layer2,
/obj/structure/chair{
	dir = 8
	},
/obj/effect/turf_decal/tile/brown/opposingcorners{
	dir = 8
	},
/turf/open/floor/iron/dark,
/area/station/cargo/exploration_office)
"EE" = (
/obj/machinery/dive_anchor/stationary,
/obj/effect/turf_decal/stripes/box,
/turf/open/floor/engine,
/area/station/cargo/exploration_office)
"ER" = (
/obj/effect/turf_decal/tile/brown/opposingcorners,
/obj/machinery/atmospherics/pipe/smart/manifold4w/supply/hidden/layer4,
/obj/machinery/atmospherics/pipe/smart/manifold4w/scrubbers/hidden/layer2,
/obj/structure/cable,
/turf/open/floor/iron,
/area/station/cargo/exploration_office)
"Ft" = (
/obj/structure/barricade/wooden,
/turf/open/misc/asteroid/airless,
/area/station/asteroid)
"FX" = (
/obj/item/stack/rods/two,
/turf/open/misc/asteroid/airless,
/area/station/asteroid)
"Ga" = (
/obj/structure/table,
/obj/item/reagent_containers/cup/bowl/soup{
	pixel_x = 8;
	pixel_y = 6;
	initial_reagent = /datum/reagent/consumable/nutriment/soup/oatmeal
	},
/obj/item/kitchen/spoon/plastic{
	pixel_x = 7;
	pixel_y = -1
	},
/obj/item/laser_pointer/blue{
	pixel_x = -1;
	pixel_y = -5
	},
/obj/effect/turf_decal/tile/brown/opposingcorners{
	dir = 8
	},
/turf/open/floor/iron/dark,
/area/station/cargo/exploration_office)
"Gp" = (
/obj/effect/turf_decal/stripes/end{
	dir = 4
	},
/obj/effect/mapping_helpers/airlock/access/any/command/gateway,
/obj/machinery/door/airlock/external{
	name = "Exploration Office Airlock"
	},
/obj/effect/mapping_helpers/airlock/cyclelink_helper{
	dir = 8
	},
/turf/open/floor/iron,
/area/station/cargo/exploration_office)
"Gt" = (
/obj/effect/turf_decal/stripes/line{
	dir = 8
	},
/obj/effect/turf_decal/sand/plating,
/obj/effect/spawner/random/trash/graffiti{
	pixel_y = 32
	},
/turf/open/floor/plating/airless,
/area/station/asteroid)
"GF" = (
/obj/effect/turf_decal/trimline/brown/filled/line{
	dir = 8
	},
/obj/structure/sign/poster/abductor/ayylian/directional/west,
/obj/structure/bed/dogbed{
	name = "Lem's bed";
	desc = "A comfy-looking cat bed. You can even strap your pet in, in case the gravity turns off."
	},
/mob/living/basic/pet/cat/space{
	name = "Lem";
	gender = "male";
	unique_pet = 1;
	desc = "He's kittened out for space exploration."
	},
/turf/open/floor/iron,
/area/station/cargo/exploration_office)
"GK" = (
/obj/effect/turf_decal/trimline/brown/filled/line{
	dir = 1
	},
/turf/open/floor/iron,
/area/station/cargo/exploration_office)
"GN" = (
/obj/machinery/door/airlock/maintenance/external{
	name = "Exploration Office Toolshed"
	},
/obj/effect/mapping_helpers/airlock/locked,
/turf/open/floor/plating,
/area/station/cargo/exploration_office)
"HW" = (
/obj/structure/closet{
	anchored = 1
	},
/obj/effect/turf_decal/tile/brown/fourcorners,
/obj/item/storage/box/colonial_rations,
/obj/item/storage/box/colonial_rations,
/obj/item/storage/box/colonial_rations,
/obj/structure/railing{
	dir = 4
	},
/turf/open/floor/iron,
/area/station/cargo/exploration_office)
"Jg" = (
/obj/machinery/atmospherics/pipe/smart/manifold4w/supply/hidden/layer4,
/obj/machinery/atmospherics/pipe/smart/manifold4w/scrubbers/hidden/layer2,
/obj/effect/turf_decal/trimline/brown/filled/line{
	dir = 4
	},
/obj/item/kirbyplants/random{
	pixel_x = 7;
	pixel_y = -6
	},
/obj/effect/turf_decal/siding/dark{
	dir = 8
	},
/turf/open/floor/iron,
/area/station/cargo/exploration_office)
"Ju" = (
/obj/machinery/atmospherics/components/unary/vent_scrubber/on/layer2{
	dir = 4
	},
/turf/open/floor/iron,
/area/station/cargo/exploration_office)
"Jx" = (
/obj/machinery/light/floor,
/obj/effect/turf_decal/siding/dark,
/turf/open/floor/iron,
/area/station/cargo/exploration_office)
"KS" = (
/obj/effect/turf_decal/stripes/line{
	dir = 4
	},
/turf/open/floor/engine,
/area/station/cargo/exploration_office)
"LF" = (
/obj/machinery/atmospherics/pipe/smart/manifold4w/supply/hidden/layer4,
/obj/machinery/atmospherics/pipe/smart/manifold4w/scrubbers/hidden/layer2,
/obj/effect/turf_decal/trimline/brown/filled/line{
	dir = 4
	},
/obj/structure/closet/firecloset/wall{
	pixel_x = 26
	},
/obj/effect/turf_decal/stripes/corner{
	dir = 4
	},
/obj/effect/turf_decal/siding/dark/corner{
	dir = 8
	},
/obj/effect/decal/cleanable/dirt,
/turf/open/floor/iron,
/area/station/cargo/exploration_office)
"ME" = (
/obj/structure/glowshroom/single,
/turf/open/misc/asteroid/airless,
/area/station/asteroid)
"MG" = (
/obj/effect/turf_decal/tile/brown/opposingcorners,
/obj/effect/landmark/navigate_destination/exploration_office,
/obj/machinery/door/airlock/mining{
	name = "Exploration Office"
	},
/obj/machinery/door/firedoor,
/obj/effect/mapping_helpers/airlock/access/any/command/gateway,
/obj/machinery/atmospherics/pipe/smart/manifold4w/supply/hidden/layer4,
/obj/machinery/atmospherics/pipe/smart/manifold4w/scrubbers/hidden/layer2,
/obj/structure/cable,
/turf/open/floor/iron,
/area/station/cargo/exploration_office)
"OC" = (
/obj/effect/turf_decal/stripes/line{
	dir = 1
	},
/obj/effect/turf_decal/stripes/line,
/obj/machinery/light/small/directional/north,
/obj/structure/sign/warning/vacuum/external/directional/south,
/obj/effect/decal/cleanable/dirt,
/turf/open/floor/iron,
/area/station/cargo/exploration_office)
"Pr" = (
/turf/open/floor/iron/textured_corner,
/area/station/cargo/exploration_office)
"Qk" = (
/obj/machinery/atmospherics/components/unary/vent_pump/on/layer4,
/obj/effect/turf_decal/trimline/brown/filled/line{
	dir = 5
	},
/obj/structure/cable,
/obj/machinery/power/apc/auto_name/directional/north,
/turf/open/floor/iron,
/area/station/cargo/drone_bay)
"Rd" = (
/obj/machinery/suit_storage_unit/explorer,
/obj/effect/turf_decal/tile/brown/fourcorners,
/turf/open/floor/iron,
/area/station/cargo/exploration_office)
"Rv" = (
/obj/effect/turf_decal/tile/brown/opposingcorners,
/obj/machinery/atmospherics/pipe/smart/manifold4w/supply/hidden/layer4,
/obj/machinery/atmospherics/pipe/smart/manifold4w/scrubbers/hidden/layer2,
/obj/machinery/light/directional/west,
/obj/structure/cable,
/turf/open/floor/iron,
/area/station/cargo/exploration_office)
"Sa" = (
/obj/effect/turf_decal/sand/plating,
/turf/open/floor/plating/airless,
/area/station/asteroid)
"SD" = (
/obj/effect/turf_decal/tile/brown/opposingcorners,
/obj/machinery/atmospherics/pipe/smart/manifold4w/supply/hidden/layer4,
/obj/machinery/atmospherics/pipe/smart/manifold4w/scrubbers/hidden/layer2,
/obj/structure/cable,
/obj/machinery/light_switch/directional/east,
/turf/open/floor/iron,
/area/station/cargo/exploration_office)
"SW" = (
/turf/closed/wall,
/area/station/cargo/exploration_office)
"Tc" = (
/obj/effect/turf_decal/stripes/line{
	dir = 1
	},
/obj/machinery/atmospherics/components/unary/vent_pump/on/layer4{
	dir = 8
	},
/turf/open/floor/engine,
/area/station/cargo/exploration_office)
"TM" = (
/obj/effect/turf_decal/sand/plating,
/obj/structure/railing{
	dir = 10
	},
/obj/structure/marker_beacon/indigo{
	pixel_x = 14;
	pixel_y = 15
	},
/turf/open/floor/plating/airless,
/area/station/asteroid)
"TQ" = (
/obj/machinery/light/floor,
/turf/open/floor/iron,
/area/station/cargo/exploration_office)
"Us" = (
/obj/effect/turf_decal/sand/plating,
/obj/structure/railing/corner/end/flip,
/turf/open/floor/plating/airless,
/area/station/asteroid)
"UH" = (
/obj/effect/decal/cleanable/dirt,
/turf/open/floor/iron,
/area/station/cargo/exploration_office)
"UK" = (
/obj/machinery/atmospherics/components/unary/vent_pump/on/layer4,
/obj/effect/turf_decal/siding/dark{
	dir = 4
	},
/obj/item/toy/cattoy,
/obj/effect/decal/cleanable/dirt,
/turf/open/floor/iron,
/area/station/cargo/exploration_office)
"UT" = (
/turf/open/misc/asteroid/airless,
/area/station/asteroid)
"Vm" = (
/obj/effect/turf_decal/trimline/brown/filled/line{
	dir = 5
	},
/obj/structure/rack,
/obj/item/multitool{
	pixel_x = -7;
	pixel_y = 2
	},
/obj/item/stack/impure_telecrystal{
	pixel_x = -6;
	pixel_y = -2
	},
/obj/item/stack/rods{
	pixel_x = 4;
	amount = 20
	},
/turf/open/floor/iron,
/area/station/cargo/exploration_office)
"VR" = (
/obj/effect/turf_decal/sand/plating,
/turf/open/misc/asteroid/airless,
/area/station/asteroid)
"WF" = (
/obj/effect/turf_decal/tile/brown/opposingcorners,
/obj/machinery/atmospherics/pipe/smart/manifold4w/supply/hidden/layer4,
/obj/machinery/atmospherics/pipe/smart/manifold4w/scrubbers/hidden/layer2,
/obj/structure/cable,
/obj/machinery/door/airlock/mining/glass{
	name = "Exploration Office"
	},
/obj/effect/mapping_helpers/airlock/access/any/command/gateway,
/obj/machinery/door/firedoor,
/turf/open/floor/iron,
/area/station/cargo/exploration_office)
"Xj" = (
/obj/effect/turf_decal/sand/plating,
/obj/structure/marker_beacon/indigo{
	pixel_x = -12;
	pixel_y = -12
	},
/obj/structure/railing/corner/end{
	dir = 8
	},
/turf/open/floor/plating/airless,
/area/station/asteroid)
"Xo" = (
/turf/open/floor/iron/textured_large,
/area/station/cargo/exploration_office)
"Xy" = (
/obj/effect/turf_decal/siding/dark,
/turf/open/floor/iron,
/area/station/cargo/exploration_office)
"XA" = (
/obj/effect/turf_decal/tile/brown/opposingcorners,
/obj/machinery/atmospherics/pipe/smart/manifold4w/supply/hidden/layer4,
/obj/machinery/atmospherics/pipe/smart/manifold4w/scrubbers/hidden/layer2,
/obj/structure/cable,
/obj/effect/spawner/random/trash/graffiti{
	pixel_x = -32
	},
/turf/open/floor/iron,
/area/station/cargo/exploration_office)
"ZB" = (
/obj/effect/turf_decal/stripes/line{
	dir = 8
	},
/obj/machinery/atmospherics/pipe/smart/manifold4w/supply/hidden/layer4,
/obj/machinery/atmospherics/pipe/smart/manifold4w/scrubbers/hidden/layer2,
/turf/open/floor/engine,
/area/station/cargo/exploration_office)
"ZD" = (
/obj/effect/turf_decal/trimline/brown/filled/line{
	dir = 9
	},
/obj/machinery/light_switch/directional/west{
	pixel_x = -22;
	pixel_y = -8
	},
/obj/structure/cable,
/obj/machinery/atmospherics/pipe/smart/manifold4w/supply/hidden/layer4,
/obj/machinery/atmospherics/pipe/smart/manifold4w/scrubbers/hidden/layer2,
/turf/open/floor/iron,
/area/station/cargo/drone_bay)
"ZW" = (
/obj/effect/turf_decal/trimline/brown/filled/line{
	dir = 4
	},
/obj/machinery/atmospherics/pipe/smart/manifold4w/supply/hidden/layer4,
/obj/machinery/atmospherics/pipe/smart/manifold4w/scrubbers/hidden/layer2,
/obj/effect/turf_decal/stripes/line{
	dir = 4
	},
/turf/open/floor/iron,
/area/station/cargo/exploration_office)

(1,1,1) = {"
SW
SW
SW
SW
SW
SW
SW
SW
SW
SW
SW
SW
SW
SW
SW
oB
oB
"}
(2,1,1) = {"
SW
ru
Rd
iP
Rd
tB
GF
ew
db
WF
ER
dr
Rv
XA
SD
MG
ZD
"}
(3,1,1) = {"
bv
us
Xo
sn
Xo
Pr
TQ
UH
mq
SW
SW
bv
bv
bv
SW
oB
Qk
"}
(4,1,1) = {"
bv
GK
qW
jg
HW
or
gn
UK
pI
SW
UT
UT
UT
cq
UT
oB
oB
"}
(5,1,1) = {"
bv
GK
or
UH
tW
or
Xy
zf
Bo
bv
UT
th
ba
TM
UT
oB
oB
"}
(6,1,1) = {"
bv
tP
iH
TQ
UH
as
Jx
Ga
Bi
bv
UT
zo
hJ
gc
UT
oB
oB
"}
(7,1,1) = {"
bv
hn
lv
Ju
or
or
Cv
eC
Ep
bv
UT
Xj
Us
pi
UT
oB
oB
"}
(8,1,1) = {"
SW
Vm
xU
li
nA
ZW
LF
Jg
aA
SW
ME
FX
Sa
UT
UT
oB
oB
"}
(9,1,1) = {"
SW
SW
xX
SW
SW
sE
SW
SW
SW
SW
jD
UT
Sa
UT
oB
oB
oB
"}
(10,1,1) = {"
bv
oL
ZB
hq
SW
OC
SW
nn
un
Ft
is
UT
UT
UT
oB
oB
oB
"}
(11,1,1) = {"
bv
Tc
EE
gH
SW
Gp
Bx
GN
un
ye
Sa
UT
Sa
cq
oB
oB
oB
"}
(12,1,1) = {"
bv
co
KS
uF
SW
Gt
UT
Sa
Sa
UT
Sa
UT
VR
UT
oB
oB
oB
"}
(13,1,1) = {"
bv
bv
bv
bv
SW
is
UT
UT
UT
UT
UT
UT
UT
oB
oB
oB
oB
"}
