//MAP CONVERTED BY dmm2tgm.py THIS HEADER COMMENT PREVENTS RECONVERSION, DO NOT REMOVE
"aa" = (
/obj/structure/barricade/wooden,
/turf/open/misc/asteroid/airless,
/area/station/asteroid)
"ax" = (
/obj/structure/rack,
/obj/effect/turf_decal/tile/brown/fourcorners,
/obj/item/radio,
/obj/item/flashlight,
/turf/open/floor/iron,
/area/station/cargo/exploration_office)
"bZ" = (
/obj/effect/turf_decal/trimline/brown/filled/line{
	dir = 6
	},
/obj/machinery/atmospherics/pipe/smart/manifold4w/supply/hidden/layer4,
/obj/machinery/atmospherics/pipe/smart/manifold4w/scrubbers/hidden/layer2,
/obj/item/kirbyplants/random,
/turf/open/floor/iron,
/area/station/cargo/exploration_office)
"cn" = (
/obj/effect/turf_decal/tile/brown/opposingcorners,
/obj/effect/landmark/navigate_destination/exploration_office,
/obj/machinery/door/airlock/mining{
	name = "Exploration Office"
	},
/obj/machinery/door/firedoor,
/obj/effect/mapping_helpers/airlock/access/any/command/gateway,
/obj/machinery/atmospherics/pipe/smart/manifold4w/supply/hidden/layer4,
/obj/machinery/atmospherics/pipe/smart/manifold4w/scrubbers/hidden/layer2,
/obj/structure/cable,
/turf/open/floor/iron,
/area/station/cargo/exploration_office)
"cO" = (
/obj/structure/tank_dispenser/oxygen,
/obj/effect/turf_decal/tile/brown/fourcorners,
/obj/structure/sign/poster/official/safety_internals/directional/west,
/turf/open/floor/iron,
/area/station/cargo/exploration_office)
"dp" = (
/obj/effect/turf_decal/trimline/brown/filled/line,
/obj/machinery/atmospherics/pipe/smart/manifold4w/supply/hidden/layer4,
/obj/machinery/atmospherics/pipe/smart/manifold4w/scrubbers/hidden/layer2,
/obj/machinery/power/apc/auto_name/directional/south,
/obj/structure/cable,
/turf/open/floor/iron,
/area/station/cargo/exploration_office)
"dz" = (
/obj/effect/turf_decal/stripes/line{
	dir = 8
	},
/obj/machinery/atmospherics/pipe/smart/manifold4w/supply/hidden/layer4,
/obj/machinery/atmospherics/pipe/smart/manifold4w/scrubbers/hidden/layer2,
/turf/open/floor/engine,
/area/station/cargo/exploration_office)
"dJ" = (
/turf/open/misc/asteroid/airless,
/area/station/asteroid)
"dL" = (
/obj/effect/turf_decal/trimline/brown/filled/line{
	dir = 4
	},
/obj/machinery/atmospherics/pipe/smart/manifold4w/supply/hidden/layer4,
/obj/machinery/atmospherics/pipe/smart/manifold4w/scrubbers/hidden/layer2,
/obj/machinery/airalarm/directional/east,
/turf/open/floor/iron,
/area/station/cargo/exploration_office)
"dN" = (
/obj/machinery/computer/anchor_controller{
	dir = 8
	},
/turf/open/floor/iron,
/area/station/cargo/exploration_office)
"eb" = (
/obj/effect/turf_decal/stripes/line{
	dir = 6
	},
/turf/open/floor/engine,
/area/station/cargo/exploration_office)
"ex" = (
/turf/closed/wall,
/area/station/cargo/exploration_office)
"fg" = (
/obj/effect/turf_decal/trimline/brown/filled/line{
	dir = 1
	},
/obj/structure/closet/crate/bin,
/turf/open/floor/iron,
/area/station/cargo/exploration_office)
"fD" = (
/obj/effect/turf_decal/trimline/brown/filled/line{
	dir = 9
	},
/obj/item/kirbyplants/random,
/turf/open/floor/iron,
/area/station/cargo/exploration_office)
"ki" = (
/obj/effect/turf_decal/stripes/line{
	dir = 9
	},
/obj/machinery/camera/autoname/directional/west,
/obj/machinery/atmospherics/pipe/smart/manifold4w/supply/hidden/layer4,
/turf/open/floor/engine,
/area/station/cargo/exploration_office)
"kA" = (
/obj/effect/turf_decal/trimline/brown/filled/line{
	dir = 8
	},
/obj/structure/bed/dogbed{
	name = "Lem's bed";
	desc = "A comfy-looking cat bed. You can even strap your pet in, in case the gravity turns off."
	},
/mob/living/basic/pet/cat/space{
	name = "Lem";
	gender = "male";
	unique_pet = 1;
	desc = "He's kittened out for space exploration."
	},
/turf/open/floor/iron,
/area/station/cargo/exploration_office)
"kR" = (
/obj/structure/sign/warning/directional/north,
/turf/open/misc/asteroid/airless,
/area/station/asteroid)
"lg" = (
/obj/effect/turf_decal/trimline/brown/filled/line,
/obj/machinery/camera/autoname/directional/south,
/obj/machinery/atmospherics/pipe/smart/manifold4w/supply/hidden/layer4,
/obj/machinery/atmospherics/pipe/smart/manifold4w/scrubbers/hidden/layer2,
/obj/structure/cable,
/turf/open/floor/iron,
/area/station/cargo/exploration_office)
"lq" = (
/turf/open/floor/iron,
/area/station/cargo/exploration_office)
"lt" = (
/obj/effect/turf_decal/trimline/brown/filled/line{
	dir = 8
	},
/turf/open/floor/iron,
/area/station/cargo/exploration_office)
"mH" = (
/obj/effect/turf_decal/trimline/brown/filled/line{
	dir = 9
	},
/obj/machinery/light_switch/directional/west{
	pixel_x = -22;
	pixel_y = -8
	},
/obj/structure/cable,
/obj/machinery/atmospherics/pipe/smart/manifold4w/supply/hidden/layer4,
/obj/machinery/atmospherics/pipe/smart/manifold4w/scrubbers/hidden/layer2,
/turf/open/floor/iron,
/area/station/cargo/drone_bay)
"mO" = (
/obj/effect/spawner/structure/window/reinforced,
/turf/open/floor/plating,
/area/station/cargo/exploration_office)
"nM" = (
/obj/structure/closet/crate,
/obj/item/stack/ore/iron,
/obj/item/stack/ore/iron,
/obj/item/pickaxe,
/turf/open/misc/asteroid/airless,
/area/station/asteroid)
"nS" = (
/obj/effect/turf_decal/stripes/line{
	dir = 5
	},
/turf/open/floor/engine,
/area/station/cargo/exploration_office)
"pC" = (
/obj/effect/turf_decal/sand/plating,
/turf/open/floor/plating/airless,
/area/station/asteroid)
"pD" = (
/obj/effect/turf_decal/trimline/brown/filled/line{
	dir = 5
	},
/obj/structure/rack,
/obj/item/stack/rods/twentyfive,
/obj/item/multitool,
/obj/item/stack/impure_telecrystal,
/turf/open/floor/iron,
/area/station/cargo/exploration_office)
"pE" = (
/obj/effect/turf_decal/tile/brown/opposingcorners,
/obj/machinery/atmospherics/pipe/smart/manifold4w/supply/hidden/layer4,
/obj/machinery/atmospherics/pipe/smart/manifold4w/scrubbers/hidden/layer2,
/obj/machinery/light/directional/west,
/obj/structure/cable,
/turf/open/floor/iron,
/area/station/cargo/exploration_office)
"rL" = (
/obj/effect/turf_decal/trimline/brown/filled/line{
	dir = 4
	},
/obj/machinery/atmospherics/pipe/smart/manifold4w/supply/hidden/layer4,
/obj/machinery/atmospherics/pipe/smart/manifold4w/scrubbers/hidden/layer2,
/turf/open/floor/iron,
/area/station/cargo/exploration_office)
"rX" = (
/obj/effect/turf_decal/tile/brown/opposingcorners,
/obj/machinery/atmospherics/pipe/smart/manifold4w/supply/hidden/layer4,
/obj/machinery/atmospherics/pipe/smart/manifold4w/scrubbers/hidden/layer2,
/obj/structure/cable,
/turf/open/floor/iron,
/area/station/cargo/exploration_office)
"tf" = (
/obj/effect/turf_decal/stripes/line{
	dir = 1
	},
/obj/machinery/atmospherics/components/unary/vent_pump/on/layer4{
	dir = 8
	},
/turf/open/floor/engine,
/area/station/cargo/exploration_office)
"tk" = (
/obj/effect/turf_decal/trimline/brown/filled/line{
	dir = 4
	},
/obj/machinery/atmospherics/pipe/smart/manifold4w/supply/hidden/layer4,
/obj/machinery/atmospherics/pipe/smart/manifold4w/scrubbers/hidden/layer2,
/obj/structure/extinguisher_cabinet/directional/east,
/turf/open/floor/iron,
/area/station/cargo/exploration_office)
"wd" = (
/obj/effect/turf_decal/sand/plating,
/obj/structure/railing{
	dir = 6
	},
/turf/open/floor/plating/airless,
/area/station/asteroid)
"wy" = (
/obj/structure/chair/office{
	dir = 4
	},
/turf/open/floor/iron,
/area/station/cargo/exploration_office)
"wF" = (
/obj/effect/turf_decal/sand/plating,
/obj/structure/railing{
	dir = 1
	},
/turf/open/floor/plating/airless,
/area/station/asteroid)
"wI" = (
/obj/effect/turf_decal/trimline/brown/filled/line,
/obj/machinery/atmospherics/pipe/smart/manifold4w/supply/hidden/layer4,
/obj/machinery/atmospherics/pipe/smart/manifold4w/scrubbers/hidden/layer2,
/turf/open/floor/iron,
/area/station/cargo/exploration_office)
"xs" = (
/obj/effect/turf_decal/stripes/line{
	dir = 10
	},
/obj/machinery/atmospherics/pipe/smart/manifold4w/scrubbers/hidden/layer2,
/turf/open/floor/engine,
/area/station/cargo/exploration_office)
"xQ" = (
/obj/effect/turf_decal/tile/brown/opposingcorners,
/obj/machinery/atmospherics/pipe/smart/manifold4w/supply/hidden/layer4,
/obj/machinery/atmospherics/pipe/smart/manifold4w/scrubbers/hidden/layer2,
/obj/structure/cable,
/obj/structure/sign/poster/official/there_is_no_gas_giant/directional/west,
/turf/open/floor/iron,
/area/station/cargo/exploration_office)
"yP" = (
/obj/effect/spawner/random/trash/food_packaging,
/turf/open/floor/iron,
/area/station/cargo/exploration_office)
"zm" = (
/obj/effect/turf_decal/stripes/line{
	dir = 4
	},
/turf/open/floor/engine,
/area/station/cargo/exploration_office)
"zK" = (
/obj/item/toy/cattoy,
/turf/open/floor/iron,
/area/station/cargo/exploration_office)
"Bq" = (
/obj/effect/turf_decal/stripes/line{
	dir = 1
	},
/obj/effect/turf_decal/stripes/line,
/obj/effect/mapping_helpers/airlock/access/any/command/gateway,
/obj/machinery/door/airlock/external{
	name = "Exploration Office Airlock"
	},
/obj/effect/mapping_helpers/airlock/cyclelink_helper{
	dir = 4
	},
/turf/open/floor/iron,
/area/station/cargo/exploration_office)
"Cj" = (
/obj/effect/turf_decal/sand/plating,
/turf/open/misc/asteroid/airless,
/area/station/asteroid)
"Da" = (
/obj/effect/turf_decal/trimline/brown/filled/line{
	dir = 1
	},
/turf/open/floor/iron,
/area/station/cargo/exploration_office)
"Eq" = (
/obj/effect/turf_decal/trimline/brown/filled/line{
	dir = 4
	},
/obj/structure/sign/warning/directional/east,
/obj/machinery/atmospherics/pipe/smart/manifold4w/supply/hidden/layer4,
/obj/machinery/atmospherics/pipe/smart/manifold4w/scrubbers/hidden/layer2,
/turf/open/floor/iron,
/area/station/cargo/exploration_office)
"Gg" = (
/obj/machinery/suit_storage_unit/standard_unit,
/obj/effect/turf_decal/tile/brown/fourcorners,
/turf/open/floor/iron,
/area/station/cargo/exploration_office)
"HA" = (
/obj/effect/turf_decal/tile/brown/opposingcorners,
/obj/machinery/atmospherics/pipe/smart/manifold4w/supply/hidden/layer4,
/obj/machinery/atmospherics/pipe/smart/manifold4w/scrubbers/hidden/layer2,
/obj/structure/cable,
/obj/machinery/light_switch/directional/east,
/turf/open/floor/iron,
/area/station/cargo/exploration_office)
"Iv" = (
/obj/machinery/atmospherics/components/unary/vent_pump/on/layer4,
/obj/effect/turf_decal/trimline/brown/filled/line{
	dir = 5
	},
/obj/structure/cable,
/obj/machinery/power/apc/auto_name/directional/north,
/turf/open/floor/iron,
/area/station/cargo/drone_bay)
"JU" = (
/obj/effect/turf_decal/trimline/brown/filled/line{
	dir = 4
	},
/obj/machinery/atmospherics/pipe/smart/manifold4w/supply/hidden/layer4,
/obj/machinery/atmospherics/pipe/smart/manifold4w/scrubbers/hidden/layer2,
/obj/machinery/firealarm/directional/east,
/turf/open/floor/iron,
/area/station/cargo/exploration_office)
"Nc" = (
/obj/effect/turf_decal/stripes/line{
	dir = 1
	},
/obj/effect/turf_decal/stripes/line,
/obj/machinery/light/small/directional/north,
/obj/structure/sign/warning/vacuum/external/directional/south,
/turf/open/floor/iron,
/area/station/cargo/exploration_office)
"NJ" = (
/obj/machinery/dive_anchor,
/turf/open/space/openspace,
/area/space/nearstation)
"NO" = (
/obj/machinery/dive_anchor/stationary,
/obj/effect/turf_decal/stripes/box,
/turf/open/floor/engine,
/area/station/cargo/exploration_office)
"Ov" = (
/obj/machinery/light/directional/south,
/obj/effect/turf_decal/stripes/line,
/obj/machinery/atmospherics/components/unary/vent_scrubber/on/layer2{
	dir = 8
	},
/turf/open/floor/engine,
/area/station/cargo/exploration_office)
"OK" = (
/obj/machinery/light/floor,
/turf/open/floor/iron,
/area/station/cargo/exploration_office)
"OL" = (
/obj/effect/turf_decal/trimline/brown/filled/line{
	dir = 1
	},
/obj/structure/table,
/obj/item/reagent_containers/cup/glass/mug{
	pixel_x = -7
	},
/obj/item/paper_bin{
	pixel_x = 7;
	pixel_y = 4
	},
/turf/open/floor/iron,
/area/station/cargo/exploration_office)
"PQ" = (
/obj/structure/closet{
	anchored = 1
	},
/obj/effect/turf_decal/tile/brown/fourcorners,
/turf/open/floor/iron,
/area/station/cargo/exploration_office)
"Qi" = (
/obj/effect/spawner/random/trash/graffiti,
/turf/closed/wall,
/area/station/cargo/exploration_office)
"RN" = (
/obj/effect/turf_decal/trimline/brown/filled/line{
	dir = 8
	},
/obj/structure/sign/poster/abductor/ayylian/directional/west,
/obj/item/kirbyplants/random,
/turf/open/floor/iron,
/area/station/cargo/exploration_office)
"Sq" = (
/obj/item/flashlight/lantern{
	pixel_x = 9
	},
/turf/open/misc/asteroid/airless,
/area/station/asteroid)
"SG" = (
/obj/effect/turf_decal/trimline/brown/filled/line{
	dir = 10
	},
/obj/machinery/atmospherics/pipe/smart/manifold4w/supply/hidden/layer4,
/obj/machinery/atmospherics/pipe/smart/manifold4w/scrubbers/hidden/layer2,
/obj/structure/cable,
/turf/open/floor/iron,
/area/station/cargo/exploration_office)
"Tl" = (
/obj/effect/turf_decal/stripes/line{
	dir = 1
	},
/obj/effect/turf_decal/stripes/line,
/obj/effect/mapping_helpers/airlock/access/any/command/gateway,
/obj/machinery/door/airlock/external{
	name = "Exploration Office Airlock"
	},
/obj/effect/mapping_helpers/airlock/cyclelink_helper{
	dir = 8
	},
/turf/open/floor/iron,
/area/station/cargo/exploration_office)
"Tu" = (
/obj/effect/turf_decal/sand/plating,
/obj/structure/railing{
	dir = 10
	},
/turf/open/floor/plating/airless,
/area/station/asteroid)
"Um" = (
/obj/machinery/atmospherics/components/unary/vent_scrubber/on/layer2{
	dir = 4
	},
/turf/open/floor/iron,
/area/station/cargo/exploration_office)
"VO" = (
/obj/machinery/atmospherics/components/unary/vent_pump/on/layer4,
/turf/open/floor/iron,
/area/station/cargo/exploration_office)
"We" = (
/obj/item/stack/rods/two,
/turf/open/misc/asteroid/airless,
/area/station/asteroid)
"Wq" = (
/turf/template_noop,
/area/template_noop)
"XI" = (
/obj/machinery/door/airlock/public/glass{
	name = "Exploration Office Inner Chamber"
	},
/obj/machinery/door/firedoor,
/obj/effect/mapping_helpers/airlock/access/any/command/gateway,
/obj/machinery/atmospherics/pipe/smart/manifold4w/supply/hidden/layer4,
/obj/machinery/atmospherics/pipe/smart/manifold4w/scrubbers/hidden/layer2,
/turf/open/floor/engine,
/area/station/cargo/exploration_office)
"ZN" = (
/obj/effect/turf_decal/sand/plating,
/obj/structure/railing{
	dir = 9
	},
/turf/open/floor/plating/airless,
/area/station/asteroid)

(1,1,1) = {"
ex
ex
ex
ex
ex
ex
ex
ex
ex
ex
ex
ex
ex
Qi
ex
Wq
Wq
"}
(2,1,1) = {"
ex
fD
Gg
cO
Gg
kA
RN
lt
SG
rX
rX
xQ
pE
rX
HA
cn
mH
"}
(3,1,1) = {"
mO
Da
lq
OK
lq
lq
OK
lq
lg
ex
ex
mO
mO
mO
ex
Wq
Iv
"}
(4,1,1) = {"
mO
Da
PQ
ax
PQ
lq
lq
VO
dp
ex
dJ
dJ
dJ
dJ
dJ
Wq
Wq
"}
(5,1,1) = {"
mO
Da
lq
lq
lq
lq
zK
lq
wI
mO
dJ
ZN
pC
Tu
dJ
Wq
Wq
"}
(6,1,1) = {"
mO
fg
wy
OK
lq
yP
OK
lq
wI
mO
dJ
wF
NJ
pC
dJ
Wq
Wq
"}
(7,1,1) = {"
mO
OL
dN
Um
lq
lq
lq
lq
wI
mO
dJ
pC
pC
wd
dJ
Wq
Wq
"}
(8,1,1) = {"
ex
pD
rL
Eq
dL
rL
tk
JU
bZ
ex
dJ
We
pC
dJ
dJ
Wq
Wq
"}
(9,1,1) = {"
ex
ex
XI
ex
ex
Bq
ex
ex
ex
ex
kR
dJ
pC
dJ
Wq
Wq
Wq
"}
(10,1,1) = {"
mO
ki
dz
xs
ex
Nc
ex
nM
Sq
dJ
dJ
dJ
dJ
dJ
Wq
Wq
Wq
"}
(11,1,1) = {"
mO
tf
NO
Ov
ex
Tl
ex
aa
aa
dJ
pC
dJ
pC
dJ
Wq
Wq
Wq
"}
(12,1,1) = {"
mO
nS
zm
eb
ex
pC
dJ
pC
pC
dJ
pC
dJ
Cj
dJ
Wq
Wq
Wq
"}
(13,1,1) = {"
mO
mO
mO
mO
ex
dJ
dJ
dJ
dJ
dJ
dJ
dJ
dJ
Wq
Wq
Wq
Wq
"}
