//MAP CONVERTED BY dmm2tgm.py THIS HEADER COMMENT PREVENTS RECONVERSION, DO NOT REMOVE
"as" = (
/obj/effect/spawner/random/trash/food_packaging,
/turf/open/floor/iron,
/area/station/cargo/exploration_office)
"aA" = (
/obj/machinery/atmospherics/pipe/smart/manifold4w/supply/hidden/layer4,
/obj/machinery/atmospherics/pipe/smart/manifold4w/scrubbers/hidden/layer2,
/obj/effect/turf_decal/tile/brown/fourcorners,
/obj/structure/reagent_dispensers/watertank,
/turf/open/floor/iron,
/area/station/cargo/exploration_office)
"bv" = (
/obj/effect/spawner/structure/window/reinforced,
/turf/open/floor/plating,
/area/station/cargo/exploration_office)
"co" = (
/obj/effect/turf_decal/stripes/line{
	dir = 5
	},
/turf/open/floor/engine,
/area/station/cargo/exploration_office)
"cq" = (
/obj/structure/flora/rock/style_random,
/turf/open/misc/asteroid/airless,
/area/station/asteroid)
"db" = (
/obj/effect/turf_decal/trimline/brown/filled/line{
	dir = 10
	},
/obj/machinery/atmospherics/pipe/smart/manifold4w/supply/hidden/layer4,
/obj/machinery/atmospherics/pipe/smart/manifold4w/scrubbers/hidden/layer2,
/obj/structure/cable,
/turf/open/floor/iron,
/area/station/cargo/exploration_office)
"dr" = (
/obj/effect/turf_decal/tile/brown/opposingcorners,
/obj/machinery/atmospherics/pipe/smart/manifold4w/supply/hidden/layer4,
/obj/machinery/atmospherics/pipe/smart/manifold4w/scrubbers/hidden/layer2,
/obj/structure/cable,
/obj/structure/sign/poster/official/there_is_no_gas_giant/directional/west,
/turf/open/floor/iron,
/area/station/cargo/exploration_office)
"ew" = (
/obj/effect/turf_decal/trimline/brown/filled/line{
	dir = 8
	},
/obj/item/kirbyplants/random{
	pixel_x = -7;
	pixel_y = 16
	},
/obj/machinery/firealarm/directional/west,
/turf/open/floor/iron,
/area/station/cargo/exploration_office)
"eC" = (
/obj/effect/landmark/start/explorer,
/turf/open/floor/iron,
/area/station/cargo/exploration_office)
"gH" = (
/obj/machinery/light/directional/south,
/obj/effect/turf_decal/stripes/line,
/obj/machinery/atmospherics/components/unary/vent_scrubber/on/layer2{
	dir = 8
	},
/turf/open/floor/engine,
/area/station/cargo/exploration_office)
"hn" = (
/obj/effect/turf_decal/trimline/brown/filled/line{
	dir = 1
	},
/obj/structure/table,
/obj/item/reagent_containers/cup/glass/mug{
	pixel_x = -7;
	list_reagents = list(/datum/reagent/consumable/coffee = 10)
	},
/obj/item/paper_bin{
	pixel_x = 7;
	pixel_y = 4
	},
/obj/item/pen,
/turf/open/floor/iron,
/area/station/cargo/exploration_office)
"hq" = (
/obj/effect/turf_decal/stripes/line{
	dir = 10
	},
/obj/machinery/atmospherics/pipe/smart/manifold4w/scrubbers/hidden/layer2,
/obj/effect/decal/cleanable/vomit/old,
/turf/open/floor/engine,
/area/station/cargo/exploration_office)
"hJ" = (
/obj/machinery/dive_anchor,
/turf/open/space/openspace,
/area/space/nearstation)
"is" = (
/obj/effect/decal/cleanable/rubble,
/turf/open/misc/asteroid/airless,
/area/station/asteroid)
"iH" = (
/obj/structure/chair/office{
	dir = 4
	},
/obj/effect/landmark/start/explorer,
/turf/open/floor/iron,
/area/station/cargo/exploration_office)
"iP" = (
/obj/structure/tank_dispenser/oxygen,
/obj/effect/turf_decal/tile/brown/fourcorners,
/obj/structure/sign/poster/official/safety_internals/directional/west,
/turf/open/floor/iron,
/area/station/cargo/exploration_office)
"jg" = (
/obj/effect/turf_decal/tile/brown/fourcorners,
/obj/item/storage/box/nri_flares{
	pixel_y = 3;
	pixel_x = -6
	},
/obj/machinery/recharger{
	pixel_x = 8;
	pixel_y = 3
	},
/obj/structure/table/reinforced,
/turf/open/floor/iron,
/area/station/cargo/exploration_office)
"jD" = (
/obj/structure/sign/warning/directional/north,
/obj/structure/flora/rock/style_random,
/turf/open/misc/asteroid/airless,
/area/station/asteroid)
"li" = (
/obj/effect/turf_decal/trimline/brown/filled/line{
	dir = 4
	},
/obj/structure/sign/warning/directional/east,
/obj/machinery/atmospherics/pipe/smart/manifold4w/supply/hidden/layer4,
/obj/machinery/atmospherics/pipe/smart/manifold4w/scrubbers/hidden/layer2,
/turf/open/floor/iron,
/area/station/cargo/exploration_office)
"lv" = (
/obj/machinery/computer/anchor_controller{
	dir = 8
	},
/turf/open/floor/iron,
/area/station/cargo/exploration_office)
"mq" = (
/obj/effect/turf_decal/trimline/brown/filled/line,
/obj/machinery/camera/autoname/directional/south,
/obj/machinery/atmospherics/pipe/smart/manifold4w/supply/hidden/layer4,
/obj/machinery/atmospherics/pipe/smart/manifold4w/scrubbers/hidden/layer2,
/obj/structure/cable,
/turf/open/floor/iron,
/area/station/cargo/exploration_office)
"nn" = (
/obj/structure/closet/crate,
/obj/item/stack/ore/iron,
/obj/item/stack/ore/iron,
/obj/item/pickaxe,
/turf/open/misc/asteroid/airless,
/area/station/asteroid)
"nA" = (
/obj/effect/turf_decal/trimline/brown/filled/line{
	dir = 4
	},
/obj/machinery/atmospherics/pipe/smart/manifold4w/supply/hidden/layer4,
/obj/machinery/atmospherics/pipe/smart/manifold4w/scrubbers/hidden/layer2,
/obj/machinery/airalarm/directional/east,
/turf/open/floor/iron,
/area/station/cargo/exploration_office)
"or" = (
/turf/open/floor/iron,
/area/station/cargo/exploration_office)
"oB" = (
/turf/template_noop,
/area/template_noop)
"oL" = (
/obj/effect/turf_decal/stripes/line{
	dir = 9
	},
/obj/machinery/camera/autoname/directional/west,
/obj/machinery/atmospherics/pipe/smart/manifold4w/supply/hidden/layer4,
/turf/open/floor/engine,
/area/station/cargo/exploration_office)
"pi" = (
/obj/effect/turf_decal/sand/plating,
/obj/structure/railing{
	dir = 6
	},
/turf/open/floor/plating/airless,
/area/station/asteroid)
"pI" = (
/obj/effect/turf_decal/trimline/brown/filled/line,
/obj/machinery/atmospherics/pipe/smart/manifold4w/supply/hidden/layer4,
/obj/machinery/atmospherics/pipe/smart/manifold4w/scrubbers/hidden/layer2,
/obj/machinery/power/apc/auto_name/directional/south,
/obj/structure/cable,
/turf/open/floor/iron,
/area/station/cargo/exploration_office)
"qW" = (
/obj/structure/closet/toolcloset,
/obj/effect/turf_decal/tile/brown/fourcorners,
/obj/item/flashlight,
/turf/open/floor/iron,
/area/station/cargo/exploration_office)
"ru" = (
/obj/effect/turf_decal/tile/brown/fourcorners,
/obj/machinery/portable_atmospherics/canister/oxygen,
/obj/effect/decal/cleanable/cobweb,
/turf/open/floor/iron,
/area/station/cargo/exploration_office)
"sn" = (
/obj/machinery/light/floor,
/obj/effect/landmark/start/explorer,
/turf/open/floor/iron,
/area/station/cargo/exploration_office)
"sE" = (
/obj/effect/turf_decal/stripes/line{
	dir = 1
	},
/obj/effect/turf_decal/stripes/line,
/obj/effect/mapping_helpers/airlock/access/any/command/gateway,
/obj/machinery/door/airlock/external{
	name = "Exploration Office Airlock"
	},
/obj/effect/mapping_helpers/airlock/cyclelink_helper{
	dir = 4
	},
/turf/open/floor/iron,
/area/station/cargo/exploration_office)
"th" = (
/obj/effect/turf_decal/sand/plating,
/obj/structure/railing{
	dir = 9
	},
/turf/open/floor/plating/airless,
/area/station/asteroid)
"tB" = (
/obj/effect/turf_decal/tile/brown/fourcorners,
/obj/machinery/recharge_station,
/turf/open/floor/iron,
/area/station/cargo/exploration_office)
"tP" = (
/obj/effect/turf_decal/trimline/brown/filled/line{
	dir = 1
	},
/obj/structure/closet/crate/bin,
/obj/effect/spawner/random/trash/garbage,
/obj/effect/spawner/random/trash/garbage,
/turf/open/floor/iron,
/area/station/cargo/exploration_office)
"us" = (
/obj/effect/turf_decal/trimline/brown/filled/line{
	dir = 1
	},
/obj/item/kirbyplants/random{
	pixel_x = -7;
	pixel_y = 16
	},
/turf/open/floor/iron,
/area/station/cargo/exploration_office)
"uF" = (
/obj/effect/turf_decal/stripes/line{
	dir = 6
	},
/turf/open/floor/engine,
/area/station/cargo/exploration_office)
"xU" = (
/obj/effect/turf_decal/trimline/brown/filled/line{
	dir = 4
	},
/obj/machinery/atmospherics/pipe/smart/manifold4w/supply/hidden/layer4,
/obj/machinery/atmospherics/pipe/smart/manifold4w/scrubbers/hidden/layer2,
/turf/open/floor/iron,
/area/station/cargo/exploration_office)
"xX" = (
/obj/machinery/door/airlock/public/glass{
	name = "Exploration Office Inner Chamber"
	},
/obj/machinery/door/firedoor,
/obj/effect/mapping_helpers/airlock/access/any/command/gateway,
/obj/machinery/atmospherics/pipe/smart/manifold4w/supply/hidden/layer4,
/obj/machinery/atmospherics/pipe/smart/manifold4w/scrubbers/hidden/layer2,
/turf/open/floor/engine,
/area/station/cargo/exploration_office)
"zo" = (
/obj/effect/turf_decal/sand/plating,
/obj/structure/railing{
	dir = 1
	},
/turf/open/floor/plating/airless,
/area/station/asteroid)
"Bi" = (
/obj/effect/turf_decal/trimline/brown/filled/line,
/obj/machinery/atmospherics/pipe/smart/manifold4w/supply/hidden/layer4,
/obj/machinery/atmospherics/pipe/smart/manifold4w/scrubbers/hidden/layer2,
/obj/effect/decal/cleanable/dirt,
/turf/open/floor/iron,
/area/station/cargo/exploration_office)
"Bx" = (
/obj/machinery/light/small/directional/west{
	pixel_x = 32
	},
/turf/closed/wall,
/area/station/cargo/exploration_office)
"Ep" = (
/obj/effect/turf_decal/trimline/brown/filled/line,
/obj/machinery/atmospherics/pipe/smart/manifold4w/supply/hidden/layer4,
/obj/machinery/atmospherics/pipe/smart/manifold4w/scrubbers/hidden/layer2,
/turf/open/floor/iron,
/area/station/cargo/exploration_office)
"EE" = (
/obj/machinery/dive_anchor/stationary,
/obj/effect/turf_decal/stripes/box,
/turf/open/floor/engine,
/area/station/cargo/exploration_office)
"ER" = (
/obj/effect/turf_decal/tile/brown/opposingcorners,
/obj/machinery/atmospherics/pipe/smart/manifold4w/supply/hidden/layer4,
/obj/machinery/atmospherics/pipe/smart/manifold4w/scrubbers/hidden/layer2,
/obj/structure/cable,
/turf/open/floor/iron,
/area/station/cargo/exploration_office)
"Ft" = (
/obj/structure/barricade/wooden,
/turf/open/misc/asteroid/airless,
/area/station/asteroid)
"FX" = (
/obj/item/stack/rods/two,
/turf/open/misc/asteroid/airless,
/area/station/asteroid)
"Gp" = (
/obj/effect/turf_decal/stripes/line{
	dir = 1
	},
/obj/effect/turf_decal/stripes/line,
/obj/effect/mapping_helpers/airlock/access/any/command/gateway,
/obj/machinery/door/airlock/external{
	name = "Exploration Office Airlock"
	},
/obj/effect/mapping_helpers/airlock/cyclelink_helper{
	dir = 8
	},
/turf/open/floor/iron,
/area/station/cargo/exploration_office)
"GF" = (
/obj/effect/turf_decal/trimline/brown/filled/line{
	dir = 8
	},
/obj/structure/sign/poster/abductor/ayylian/directional/west,
/obj/structure/bed/dogbed{
	name = "Lem's bed";
	desc = "A comfy-looking cat bed. You can even strap your pet in, in case the gravity turns off."
	},
/mob/living/basic/pet/cat/space{
	name = "Lem";
	gender = "male";
	unique_pet = 1;
	desc = "He's kittened out for space exploration."
	},
/turf/open/floor/iron,
/area/station/cargo/exploration_office)
"GK" = (
/obj/effect/turf_decal/trimline/brown/filled/line{
	dir = 1
	},
/turf/open/floor/iron,
/area/station/cargo/exploration_office)
"GN" = (
/obj/item/grown/bananapeel,
/turf/open/misc/asteroid/airless,
/area/station/asteroid)
"HW" = (
/obj/structure/closet{
	anchored = 1
	},
/obj/effect/turf_decal/tile/brown/fourcorners,
/obj/item/storage/box/colonial_rations,
/obj/item/storage/box/colonial_rations,
/obj/item/storage/box/colonial_rations,
/turf/open/floor/iron,
/area/station/cargo/exploration_office)
"Jg" = (
/obj/machinery/atmospherics/pipe/smart/manifold4w/supply/hidden/layer4,
/obj/machinery/atmospherics/pipe/smart/manifold4w/scrubbers/hidden/layer2,
/obj/structure/reagent_dispensers/fueltank,
/obj/effect/turf_decal/tile/brown/fourcorners,
/obj/structure/railing{
	dir = 1
	},
/turf/open/floor/iron,
/area/station/cargo/exploration_office)
"Ju" = (
/obj/machinery/atmospherics/components/unary/vent_scrubber/on/layer2{
	dir = 4
	},
/turf/open/floor/iron,
/area/station/cargo/exploration_office)
"Jx" = (
/obj/item/flashlight/lantern{
	pixel_x = 9
	},
/turf/open/misc/asteroid/airless,
/area/station/asteroid)
"KS" = (
/obj/effect/turf_decal/stripes/line{
	dir = 4
	},
/turf/open/floor/engine,
/area/station/cargo/exploration_office)
"LF" = (
/obj/machinery/atmospherics/pipe/smart/manifold4w/supply/hidden/layer4,
/obj/machinery/atmospherics/pipe/smart/manifold4w/scrubbers/hidden/layer2,
/obj/structure/extinguisher_cabinet/directional/east,
/obj/effect/turf_decal/trimline/brown/filled/line{
	dir = 4
	},
/obj/item/kirbyplants/random{
	pixel_x = 7
	},
/turf/open/floor/iron,
/area/station/cargo/exploration_office)
"ME" = (
/obj/structure/glowshroom/single,
/turf/open/misc/asteroid/airless,
/area/station/asteroid)
"MG" = (
/obj/effect/turf_decal/tile/brown/opposingcorners,
/obj/effect/landmark/navigate_destination/exploration_office,
/obj/machinery/door/airlock/mining{
	name = "Exploration Office"
	},
/obj/machinery/door/firedoor,
/obj/effect/mapping_helpers/airlock/access/any/command/gateway,
/obj/machinery/atmospherics/pipe/smart/manifold4w/supply/hidden/layer4,
/obj/machinery/atmospherics/pipe/smart/manifold4w/scrubbers/hidden/layer2,
/obj/structure/cable,
/turf/open/floor/iron,
/area/station/cargo/exploration_office)
"OC" = (
/obj/effect/turf_decal/stripes/line{
	dir = 1
	},
/obj/effect/turf_decal/stripes/line,
/obj/machinery/light/small/directional/north,
/obj/structure/sign/warning/vacuum/external/directional/south,
/obj/effect/decal/cleanable/dirt,
/turf/open/floor/iron,
/area/station/cargo/exploration_office)
"Qk" = (
/obj/machinery/atmospherics/components/unary/vent_pump/on/layer4,
/obj/effect/turf_decal/trimline/brown/filled/line{
	dir = 5
	},
/obj/structure/cable,
/obj/machinery/power/apc/auto_name/directional/north,
/turf/open/floor/iron,
/area/station/cargo/drone_bay)
"Rd" = (
/obj/machinery/suit_storage_unit/explorer,
/obj/effect/turf_decal/tile/brown/fourcorners,
/turf/open/floor/iron,
/area/station/cargo/exploration_office)
"Rv" = (
/obj/effect/turf_decal/tile/brown/opposingcorners,
/obj/machinery/atmospherics/pipe/smart/manifold4w/supply/hidden/layer4,
/obj/machinery/atmospherics/pipe/smart/manifold4w/scrubbers/hidden/layer2,
/obj/machinery/light/directional/west,
/obj/structure/cable,
/turf/open/floor/iron,
/area/station/cargo/exploration_office)
"Sa" = (
/obj/effect/turf_decal/sand/plating,
/turf/open/floor/plating/airless,
/area/station/asteroid)
"SD" = (
/obj/effect/turf_decal/tile/brown/opposingcorners,
/obj/machinery/atmospherics/pipe/smart/manifold4w/supply/hidden/layer4,
/obj/machinery/atmospherics/pipe/smart/manifold4w/scrubbers/hidden/layer2,
/obj/structure/cable,
/obj/machinery/light_switch/directional/east,
/turf/open/floor/iron,
/area/station/cargo/exploration_office)
"SW" = (
/turf/closed/wall,
/area/station/cargo/exploration_office)
"Tc" = (
/obj/effect/turf_decal/stripes/line{
	dir = 1
	},
/obj/machinery/atmospherics/components/unary/vent_pump/on/layer4{
	dir = 8
	},
/turf/open/floor/engine,
/area/station/cargo/exploration_office)
"TM" = (
/obj/effect/turf_decal/sand/plating,
/obj/structure/railing{
	dir = 10
	},
/turf/open/floor/plating/airless,
/area/station/asteroid)
"TQ" = (
/obj/machinery/light/floor,
/turf/open/floor/iron,
/area/station/cargo/exploration_office)
"UH" = (
/obj/effect/decal/cleanable/dirt,
/turf/open/floor/iron,
/area/station/cargo/exploration_office)
"UK" = (
/obj/machinery/atmospherics/components/unary/vent_pump/on/layer4,
/turf/open/floor/iron,
/area/station/cargo/exploration_office)
"UT" = (
/turf/open/misc/asteroid/airless,
/area/station/asteroid)
"Vm" = (
/obj/effect/turf_decal/trimline/brown/filled/line{
	dir = 5
	},
/obj/structure/rack,
/obj/item/multitool{
	pixel_x = -7;
	pixel_y = 2
	},
/obj/item/stack/impure_telecrystal{
	pixel_x = -6;
	pixel_y = -2
	},
/obj/item/stack/rods{
	pixel_x = 4;
	amount = 20
	},
/turf/open/floor/iron,
/area/station/cargo/exploration_office)
"VR" = (
/obj/effect/turf_decal/sand/plating,
/turf/open/misc/asteroid/airless,
/area/station/asteroid)
"WF" = (
/obj/effect/turf_decal/tile/brown/opposingcorners,
/obj/machinery/atmospherics/pipe/smart/manifold4w/supply/hidden/layer4,
/obj/machinery/atmospherics/pipe/smart/manifold4w/scrubbers/hidden/layer2,
/obj/structure/cable,
/obj/machinery/door/airlock/mining/glass{
	name = "Exploration Office"
	},
/obj/effect/mapping_helpers/airlock/access/any/command/gateway,
/obj/machinery/door/firedoor,
/turf/open/floor/iron,
/area/station/cargo/exploration_office)
"Xy" = (
/obj/item/toy/cattoy,
/turf/open/floor/iron,
/area/station/cargo/exploration_office)
"XA" = (
/obj/effect/turf_decal/tile/brown/opposingcorners,
/obj/machinery/atmospherics/pipe/smart/manifold4w/supply/hidden/layer4,
/obj/machinery/atmospherics/pipe/smart/manifold4w/scrubbers/hidden/layer2,
/obj/structure/cable,
/obj/effect/spawner/random/trash/graffiti{
	pixel_x = -32
	},
/turf/open/floor/iron,
/area/station/cargo/exploration_office)
"ZB" = (
/obj/effect/turf_decal/stripes/line{
	dir = 8
	},
/obj/machinery/atmospherics/pipe/smart/manifold4w/supply/hidden/layer4,
/obj/machinery/atmospherics/pipe/smart/manifold4w/scrubbers/hidden/layer2,
/turf/open/floor/engine,
/area/station/cargo/exploration_office)
"ZD" = (
/obj/effect/turf_decal/trimline/brown/filled/line{
	dir = 9
	},
/obj/machinery/light_switch/directional/west{
	pixel_x = -22;
	pixel_y = -8
	},
/obj/structure/cable,
/obj/machinery/atmospherics/pipe/smart/manifold4w/supply/hidden/layer4,
/obj/machinery/atmospherics/pipe/smart/manifold4w/scrubbers/hidden/layer2,
/turf/open/floor/iron,
/area/station/cargo/drone_bay)

(1,1,1) = {"
SW
SW
SW
SW
SW
SW
SW
SW
SW
SW
SW
SW
SW
SW
SW
oB
oB
"}
(2,1,1) = {"
SW
ru
Rd
iP
Rd
tB
GF
ew
db
WF
ER
dr
Rv
XA
SD
MG
ZD
"}
(3,1,1) = {"
bv
us
or
sn
or
or
TQ
UH
mq
SW
SW
bv
bv
bv
SW
oB
Qk
"}
(4,1,1) = {"
bv
GK
qW
jg
HW
or
or
UK
pI
SW
UT
UT
UT
cq
UT
oB
oB
"}
(5,1,1) = {"
bv
GK
or
or
UH
or
Xy
or
Ep
bv
UT
th
Sa
TM
UT
oB
oB
"}
(6,1,1) = {"
bv
tP
iH
TQ
or
as
TQ
or
Bi
bv
UT
zo
hJ
Sa
UT
oB
oB
"}
(7,1,1) = {"
bv
hn
lv
Ju
or
or
UH
eC
Ep
bv
UT
Sa
Sa
pi
UT
oB
oB
"}
(8,1,1) = {"
SW
Vm
xU
li
nA
xU
LF
Jg
aA
SW
ME
FX
Sa
UT
UT
oB
oB
"}
(9,1,1) = {"
SW
SW
xX
SW
SW
sE
SW
SW
SW
SW
jD
UT
Sa
UT
oB
oB
oB
"}
(10,1,1) = {"
bv
oL
ZB
hq
SW
OC
SW
nn
Jx
GN
is
UT
UT
UT
oB
oB
oB
"}
(11,1,1) = {"
bv
Tc
EE
gH
SW
Gp
Bx
Ft
Ft
UT
Sa
UT
Sa
cq
oB
oB
oB
"}
(12,1,1) = {"
bv
co
KS
uF
SW
Sa
UT
Sa
Sa
UT
Sa
UT
VR
UT
oB
oB
oB
"}
(13,1,1) = {"
bv
bv
bv
bv
SW
is
UT
UT
UT
UT
UT
UT
UT
oB
oB
oB
oB
"}
