//MAP CONVERTED BY dmm2tgm.py THIS HEADER COMMENT PREVENTS RECONVERSION, DO NOT REMOVE
"a" = (
/obj/structure/table/reinforced,
/obj/effect/turf_decal/tile/blue{
	dir = 8
	},
/obj/machinery/fax{
	fax_name = "Bridge";
	name = "Bridge Fax Machine"
	},
/turf/open/floor/iron/dark/side{
	dir = 8
	},
/area/station/command/bridge)

(1,1,1) = {"
a
"}
