//MAP CONVERTED BY dmm2tgm.py THIS HEADER COMMENT PREVENTS RECONVERSION, DO NOT REMOVE
"a" = (
/obj/machinery/atmospherics/pipe/smart/manifold4w/scrubbers/hidden/layer2,
/obj/machinery/atmospherics/pipe/smart/manifold4w/supply/hidden/layer4,
/obj/structure/cable,
/obj/effect/landmark/start/explorer,
/turf/open/floor/iron,
/area/station/command/teleporter)
"J" = (
/turf/template_noop,
/area/template_noop)

(1,1,1) = {"
a
J
a
J
a
"}
