//MAP CONVERTED BY dmm2tgm.py THIS HEADER COMMENT PREVENTS RECONVERSION, DO NOT REMOVE
"a" = (
/obj/structure/cable,
/obj/machinery/atmospherics/pipe/smart/manifold4w/supply/hidden/layer4,
/obj/machinery/atmospherics/pipe/smart/manifold4w/scrubbers/hidden/layer2,
/obj/machinery/light/warm/directional/north,
/obj/structure/phone_base/captain{
	pixel_x = 0;
	pixel_y = 26
	},
/turf/open/floor/wood,
/area/station/command/heads_quarters/captain)

(1,1,1) = {"
a
"}
