//MAP CONVERTED BY dmm2tgm.py THIS HEADER COMMENT PREVENTS RECONVERSION, DO NOT REMOVE
"aa" = (
/obj/machinery/power/shuttle_engine/propulsion/burst{
	dir = 4
	},
/turf/closed/wall/mineral/titanium/interior,
/area/ruin/powered/hermit)
"aM" = (
/turf/open/misc/asteroid/snow/icemoon,
/area/icemoon/underground/explored)
"aT" = (
/obj/structure/chair/sofa/corp/right{
	dir = 1
	},
/obj/effect/turf_decal/siding/wood{
	dir = 1
	},
/turf/open/floor/wood,
/area/ruin/powered/hermit)
"bo" = (
/obj/effect/turf_decal/weather/dirt{
	dir = 6
	},
/obj/effect/turf_decal/weather/dirt{
	dir = 5
	},
/turf/open/water/hot_spring/icemoon,
/area/icemoon/underground/explored)
"bp" = (
/obj/structure/rack,
/obj/item/clothing/suit/hooded/wintercoat,
/obj/item/gun/energy/laser/musket/prime,
/obj/item/knife/combat,
/obj/effect/turf_decal/siding/wood{
	dir = 10
	},
/turf/open/floor/wood,
/area/ruin/powered/hermit)
"bu" = (
/obj/item/flashlight/lantern,
/obj/effect/turf_decal/weather/dirt{
	dir = 10
	},
/turf/open/misc/asteroid/snow/icemoon,
/area/icemoon/underground/explored)
"ch" = (
/obj/structure/flora/tree/pine/style_random,
/obj/effect/turf_decal/weather/dirt{
	dir = 6
	},
/turf/open/misc/asteroid/snow/icemoon,
/area/icemoon/underground/explored)
"cB" = (
/obj/effect/turf_decal/weather/dirt{
	dir = 1
	},
/turf/open/misc/asteroid/snow/icemoon,
/area/icemoon/underground/explored)
"cI" = (
/obj/structure/chair/sofa/corp/left{
	dir = 1
	},
/obj/effect/turf_decal/siding/wood{
	dir = 1
	},
/turf/open/floor/wood,
/area/ruin/powered/hermit)
"cZ" = (
/obj/machinery/hydroponics/soil,
/turf/open/floor/grass/fairy/icemoon,
/area/icemoon/underground/explored)
"dY" = (
/obj/structure/flora/bush/snow,
/turf/open/misc/asteroid/snow/icemoon,
/area/icemoon/underground/explored)
"et" = (
/obj/item/chair,
/turf/open/floor/plating,
/area/ruin/powered/hermit)
"eI" = (
/obj/structure/flora/lunar_plant/style_2,
/obj/effect/turf_decal/weather/dirt{
	dir = 1
	},
/turf/open/floor/grass/fairy,
/area/ruin/powered/hermit)
"ha" = (
/obj/effect/turf_decal/siding/wood{
	dir = 5
	},
/obj/item/flatpacked_machine,
/turf/open/floor/wood,
/area/ruin/powered/hermit)
"hC" = (
/obj/effect/turf_decal/weather/dirt{
	dir = 8
	},
/obj/structure/flora/rock/icy/style_random,
/turf/open/misc/asteroid/snow/icemoon,
/area/icemoon/underground/explored)
"hN" = (
/obj/machinery/hydroponics/constructable,
/obj/effect/turf_decal/weather/dirt{
	dir = 10
	},
/turf/open/floor/grass/fairy,
/area/ruin/powered/hermit)
"ii" = (
/turf/open/floor/wood/stairs/right,
/area/ruin/powered/hermit)
"il" = (
/turf/open/misc/dirt/icemoon,
/area/icemoon/underground/explored)
"im" = (
/obj/structure/flora/bush/snow,
/obj/structure/flora/bush/sparsegrass/style_random,
/turf/open/misc/asteroid/snow/icemoon,
/area/icemoon/underground/explored)
"io" = (
/obj/machinery/door/airlock/titanium{
	name = "Escape Pod Airlock"
	},
/turf/open/floor/plating,
/area/ruin/powered/hermit)
"jG" = (
/obj/effect/spawner/structure/window/reinforced/shuttle,
/turf/open/floor/plating,
/area/ruin/powered/hermit)
"jY" = (
/obj/structure/flora/rock/pile/icy/style_random,
/turf/open/misc/asteroid/snow/icemoon,
/area/icemoon/underground/explored)
"kn" = (
/obj/effect/turf_decal/weather/dirt{
	dir = 1
	},
/obj/structure/flora/bush/sparsegrass/style_random,
/turf/open/misc/asteroid/snow/icemoon,
/area/icemoon/underground/explored)
"kr" = (
/obj/effect/turf_decal/weather/dirt{
	dir = 8
	},
/turf/open/misc/asteroid/snow/icemoon,
/area/icemoon/underground/explored)
"lN" = (
/obj/effect/turf_decal/weather/dirt{
	dir = 4
	},
/obj/structure/flora/bush/snow,
/turf/open/misc/asteroid/snow/icemoon,
/area/icemoon/underground/explored)
"ml" = (
/obj/item/toy/plush/lizard_plushie/green{
	pixel_x = 9;
	name = "Scared-Of-Cold";
	desc = "An adorable stuffed toy that resembles a green lizardperson. This one shivers without their furry friend."
	},
/obj/item/toy/plush/moth{
	pixel_x = -9;
	desc = "A plushie depicting an adorable mothperson. Its warm to the touch, and seems happy to keep ther scaly friend warm.";
	name = "Patches"
	},
/turf/open/misc/asteroid/snow/icemoon,
/area/icemoon/underground/explored)
"mB" = (
/obj/structure/table/wood,
/obj/item/paper/guides/jobs/hydroponics{
	pixel_x = -8
	},
/obj/item/reagent_containers/cup/bucket/wooden{
	pixel_x = 6;
	pixel_y = 5
	},
/obj/item/cultivator{
	pixel_x = -8
	},
/obj/item/storage/bag/plants/portaseeder,
/obj/effect/turf_decal/weather/dirt{
	dir = 10
	},
/turf/open/floor/grass/fairy,
/area/ruin/powered/hermit)
"mF" = (
/obj/effect/turf_decal/siding/wood{
	dir = 8
	},
/obj/effect/turf_decal/siding/wood/corner{
	dir = 4
	},
/turf/open/floor/wood,
/area/ruin/powered/hermit)
"oo" = (
/obj/machinery/hydroponics/constructable,
/obj/effect/turf_decal/weather/dirt{
	dir = 9
	},
/turf/open/floor/grass/fairy,
/area/ruin/powered/hermit)
"oJ" = (
/turf/open/floor/grass/fairy,
/area/ruin/powered/hermit)
"ph" = (
/obj/structure/rack,
/obj/item/seeds/plump,
/obj/item/seeds/tower,
/obj/item/food/grown/mushroom/glowshroom,
/obj/item/seeds/reishi,
/obj/item/seeds/cotton,
/obj/structure/sink/directional/west,
/obj/item/seeds/cocoapod,
/obj/effect/turf_decal/weather/dirt{
	dir = 6
	},
/obj/item/seeds/grass,
/turf/open/floor/grass/fairy,
/area/ruin/powered/hermit)
"pA" = (
/turf/closed/wall/prefab_plastic,
/area/ruin/powered/hermit)
"qs" = (
/obj/effect/turf_decal/siding/wood{
	dir = 8
	},
/turf/open/floor/wood,
/area/ruin/powered/hermit)
"rA" = (
/obj/structure/railing/wooden_fencing{
	dir = 1
	},
/obj/structure/railing/wooden_fencing{
	dir = 8
	},
/turf/open/floor/wood,
/area/ruin/powered/hermit)
"sC" = (
/obj/structure/curtain/bounty,
/turf/open/floor/wood,
/area/ruin/powered/hermit)
"sJ" = (
/obj/effect/turf_decal/siding/wood/corner{
	dir = 4
	},
/turf/open/floor/wood,
/area/ruin/powered/hermit)
"tj" = (
/obj/structure/flora/rock/icy/style_random,
/turf/open/misc/asteroid/snow/icemoon,
/area/icemoon/underground/explored)
"uw" = (
/obj/structure/flora/tree/pine/style_random,
/turf/open/misc/asteroid/snow/icemoon,
/area/icemoon/underground/explored)
"vf" = (
/obj/effect/turf_decal/weather/dirt,
/obj/effect/turf_decal/weather/snow/corner{
	dir = 4
	},
/obj/effect/turf_decal/weather/snow/corner{
	dir = 8
	},
/turf/open/floor/grass/fairy/icemoon,
/area/icemoon/underground/explored)
"vy" = (
/obj/effect/turf_decal/weather/snow/corner{
	dir = 4
	},
/turf/open/floor/grass/fairy/icemoon,
/area/icemoon/underground/explored)
"wH" = (
/obj/structure/flora/tree/jungle/small/style_6,
/turf/open/floor/grass/fairy/icemoon,
/area/icemoon/underground/explored)
"yx" = (
/obj/effect/turf_decal/weather/dirt{
	dir = 5
	},
/turf/open/floor/grass/fairy,
/area/ruin/powered/hermit)
"yG" = (
/obj/effect/turf_decal/siding/wood,
/turf/open/floor/wood,
/area/ruin/powered/hermit)
"za" = (
/obj/effect/turf_decal/weather/dirt{
	dir = 4
	},
/turf/open/water/hot_spring/icemoon,
/area/icemoon/underground/explored)
"zd" = (
/obj/structure/table/wood,
/obj/item/storage/medkit/surgery{
	pixel_x = -4
	},
/obj/effect/turf_decal/siding/wood/end{
	dir = 1
	},
/turf/open/floor/wood,
/area/ruin/powered/hermit)
"zj" = (
/obj/effect/turf_decal/weather/dirt{
	dir = 10
	},
/turf/open/misc/asteroid/snow/icemoon,
/area/icemoon/underground/explored)
"BC" = (
/obj/effect/turf_decal/weather/dirt{
	dir = 6
	},
/turf/open/floor/grass/fairy,
/area/ruin/powered/hermit)
"Cd" = (
/obj/effect/turf_decal/weather/dirt{
	dir = 1
	},
/obj/effect/turf_decal/weather/dirt,
/obj/effect/turf_decal/weather/dirt{
	dir = 4
	},
/turf/open/misc/asteroid/snow/icemoon,
/area/icemoon/underground/explored)
"Cx" = (
/obj/structure/flora/bush/sparsegrass/style_random,
/turf/open/misc/asteroid/snow/icemoon,
/area/icemoon/underground/explored)
"Cz" = (
/obj/effect/turf_decal/weather/dirt{
	dir = 4
	},
/obj/structure/flora/bush/sparsegrass/style_random,
/turf/open/misc/asteroid/snow/icemoon,
/area/icemoon/underground/explored)
"CR" = (
/turf/closed/mineral/snowmountain/icemoon,
/area/icemoon/underground/explored)
"CU" = (
/obj/item/flashlight/lantern,
/obj/effect/turf_decal/weather/snow/corner{
	dir = 6
	},
/turf/open/floor/grass/fairy/icemoon,
/area/icemoon/underground/explored)
"Dm" = (
/obj/machinery/hydroponics/soil,
/obj/effect/turf_decal/weather/snow/corner{
	dir = 5
	},
/turf/open/floor/grass/fairy/icemoon,
/area/icemoon/underground/explored)
"Dr" = (
/obj/effect/turf_decal/weather/snow/corner{
	dir = 6
	},
/obj/effect/turf_decal/weather/snow/corner{
	dir = 5
	},
/obj/structure/flora/lunar_plant/style_1,
/turf/open/floor/grass/fairy/icemoon,
/area/icemoon/underground/explored)
"DM" = (
/obj/effect/turf_decal/siding/dark{
	dir = 10
	},
/turf/open/floor/wood/parquet,
/area/ruin/powered/hermit)
"DP" = (
/obj/structure/mineral_door/manual_colony_door,
/obj/structure/fans/tiny,
/turf/open/floor/iron/colony/bolts,
/area/ruin/powered/hermit)
"DW" = (
/obj/item/tank/internals/emergency_oxygen/engi,
/obj/structure/table/wood,
/obj/item/storage/toolbox/emergency,
/obj/machinery/light/small/directional/east,
/obj/effect/turf_decal/siding/wood{
	dir = 4
	},
/obj/item/stack/sheet/glass/fifty,
/obj/item/stack/sheet/iron/twenty,
/turf/open/floor/wood,
/area/ruin/powered/hermit)
"Eo" = (
/obj/item/storage/toolbox/fishing,
/turf/open/misc/dirt/icemoon,
/area/icemoon/underground/explored)
"Ey" = (
/obj/structure/closet/cabinet,
/obj/effect/turf_decal/siding/wood{
	dir = 5
	},
/turf/open/floor/wood,
/area/ruin/powered/hermit)
"Fp" = (
/obj/effect/turf_decal/weather/dirt,
/turf/open/floor/grass/fairy,
/area/ruin/powered/hermit)
"Fs" = (
/obj/machinery/biogenerator/food_replicator,
/obj/effect/turf_decal/weather/dirt{
	dir = 1
	},
/turf/open/floor/grass/fairy,
/area/ruin/powered/hermit)
"Gm" = (
/obj/effect/turf_decal/weather/snow/corner{
	dir = 9
	},
/obj/effect/turf_decal/weather/snow/corner{
	dir = 10
	},
/turf/open/floor/grass/fairy/icemoon,
/area/icemoon/underground/explored)
"GH" = (
/obj/effect/turf_decal/siding/dark{
	dir = 6
	},
/turf/open/floor/wood/parquet,
/area/ruin/powered/hermit)
"GI" = (
/obj/effect/turf_decal/weather/dirt,
/turf/open/misc/asteroid/snow/icemoon,
/area/icemoon/underground/explored)
"GS" = (
/obj/effect/turf_decal/weather/dirt{
	dir = 8
	},
/obj/structure/flora/rock/pile/icy/style_random,
/turf/open/misc/asteroid/snow/icemoon,
/area/icemoon/underground/explored)
"Il" = (
/obj/effect/turf_decal/weather/dirt{
	dir = 9
	},
/obj/effect/turf_decal/weather/dirt{
	dir = 10
	},
/turf/open/water/hot_spring/icemoon,
/area/icemoon/underground/explored)
"ID" = (
/obj/structure/fireplace{
	light_angle = 360
	},
/turf/open/floor/iron/colony/texture,
/area/ruin/powered/hermit)
"Jc" = (
/obj/effect/turf_decal/weather/dirt{
	dir = 4
	},
/turf/open/misc/asteroid/snow/icemoon,
/area/icemoon/underground/explored)
"JI" = (
/obj/machinery/light_switch/directional/south,
/obj/effect/turf_decal/siding/wood,
/turf/open/floor/wood,
/area/ruin/powered/hermit)
"Le" = (
/obj/structure/rack/shelf,
/obj/item/storage/bag/ore{
	pixel_x = 5
	},
/obj/item/pickaxe/emergency,
/turf/open/floor/iron/colony/texture,
/area/ruin/powered/hermit)
"Lf" = (
/obj/structure/flora/tree/jungle/small/style_random,
/turf/open/misc/dirt/icemoon,
/area/icemoon/underground/explored)
"Lh" = (
/obj/effect/turf_decal/weather/dirt{
	dir = 10
	},
/obj/structure/flora/bush/style_random,
/turf/open/water/hot_spring/icemoon,
/area/icemoon/underground/explored)
"Lz" = (
/obj/effect/turf_decal/weather/dirt{
	dir = 8
	},
/turf/open/water/hot_spring/icemoon,
/area/icemoon/underground/explored)
"LG" = (
/obj/machinery/biogenerator/organic_printer,
/obj/machinery/light/small/directional/west,
/obj/effect/turf_decal/weather/dirt{
	dir = 8
	},
/turf/open/floor/grass/fairy,
/area/ruin/powered/hermit)
"Mp" = (
/obj/effect/turf_decal/weather/dirt{
	dir = 4
	},
/turf/open/floor/grass/fairy,
/area/ruin/powered/hermit)
"MN" = (
/obj/structure/railing/wooden_fencing{
	dir = 8
	},
/obj/structure/curtain/bounty,
/turf/open/floor/wood,
/area/ruin/powered/hermit)
"MR" = (
/obj/effect/turf_decal/siding/dark{
	dir = 9
	},
/turf/open/floor/wood/parquet,
/area/ruin/powered/hermit)
"Nw" = (
/obj/effect/turf_decal/weather/dirt{
	dir = 1
	},
/obj/structure/flora/rock/pile/icy/style_random,
/turf/open/misc/asteroid/snow/icemoon,
/area/icemoon/underground/explored)
"NP" = (
/obj/effect/turf_decal/weather/dirt{
	dir = 6
	},
/turf/open/misc/asteroid/snow/icemoon,
/area/icemoon/underground/explored)
"Oc" = (
/obj/effect/turf_decal/weather/dirt,
/turf/open/water/hot_spring/icemoon,
/area/icemoon/underground/explored)
"OL" = (
/obj/effect/turf_decal/siding/dark,
/turf/open/floor/wood/parquet,
/area/ruin/powered/hermit)
"ON" = (
/obj/effect/mob_spawn/ghost_role/human/hermit{
	dir = 1
	},
/turf/open/floor/plating,
/area/ruin/powered/hermit)
"Po" = (
/obj/item/chair/wood/wings,
/obj/effect/turf_decal/weather/snow/corner,
/turf/open/floor/grass/fairy/icemoon,
/area/icemoon/underground/explored)
"Qh" = (
/obj/effect/turf_decal/weather/dirt{
	dir = 5
	},
/obj/structure/flora/bush/reed/style_random,
/turf/open/water/hot_spring/icemoon,
/area/icemoon/underground/explored)
"Qz" = (
/obj/item/toy/plush/carpplushie{
	name = "Fishie"
	},
/turf/open/water/hot_spring/icemoon,
/area/icemoon/underground/explored)
"QD" = (
/turf/template_noop,
/area/template_noop)
"QN" = (
/obj/effect/turf_decal/weather/dirt{
	dir = 9
	},
/turf/open/water/hot_spring/icemoon,
/area/icemoon/underground/explored)
"QW" = (
/obj/effect/turf_decal/siding/dark{
	dir = 1
	},
/turf/open/floor/wood/parquet,
/area/ruin/powered/hermit)
"Rd" = (
/obj/structure/chair/comfy/beige{
	dir = 4
	},
/turf/open/floor/wood,
/area/ruin/powered/hermit)
"Rr" = (
/turf/closed/wall/mineral/titanium/interior,
/area/ruin/powered/hermit)
"Se" = (
/obj/effect/turf_decal/siding/dark{
	dir = 5
	},
/turf/open/floor/wood/parquet,
/area/ruin/powered/hermit)
"Si" = (
/obj/structure/chair/sofa/corp{
	dir = 1
	},
/obj/effect/turf_decal/siding/wood{
	dir = 1
	},
/turf/open/floor/wood,
/area/ruin/powered/hermit)
"SP" = (
/obj/item/stack/sheet/mineral/wood/fifty,
/obj/item/storage/box/matches{
	pixel_x = -3
	},
/obj/structure/rack,
/turf/open/floor/iron/colony/texture,
/area/ruin/powered/hermit)
"TL" = (
/obj/item/shovel,
/turf/open/misc/asteroid/snow/icemoon,
/area/icemoon/underground/explored)
"Uw" = (
/obj/structure/window/fulltile/colony_fabricator,
/obj/structure/barricade/wooden/crude/snow,
/obj/structure/curtain/bounty/start_closed,
/turf/open/floor/plating,
/area/ruin/powered/hermit)
"UH" = (
/obj/effect/turf_decal/weather/snow/corner{
	dir = 8
	},
/turf/open/floor/grass/fairy/icemoon,
/area/icemoon/underground/explored)
"Vi" = (
/turf/open/floor/grass/fairy/icemoon,
/area/icemoon/underground/explored)
"VD" = (
/obj/machinery/portable_atmospherics/canister/oxygen,
/obj/effect/turf_decal/siding/wood{
	dir = 6
	},
/turf/open/floor/wood,
/area/ruin/powered/hermit)
"Xl" = (
/obj/structure/mineral_door/manual_colony_door,
/turf/open/floor/iron/colony/bolts,
/area/ruin/powered/hermit)
"XI" = (
/obj/machinery/light/small/directional/west,
/turf/open/floor/iron/colony/bolts,
/area/ruin/powered/hermit)
"Ys" = (
/obj/structure/railing/wooden_fencing,
/turf/open/floor/wood,
/area/ruin/powered/hermit)
"YA" = (
/obj/effect/turf_decal/weather/dirt{
	dir = 5
	},
/turf/open/water/hot_spring/icemoon,
/area/icemoon/underground/explored)
"Zu" = (
/obj/machinery/hydroponics/constructable,
/obj/effect/turf_decal/weather/dirt{
	dir = 5
	},
/obj/effect/turf_decal/weather/dirt{
	dir = 6
	},
/turf/open/floor/grass/fairy,
/area/ruin/powered/hermit)
"ZO" = (
/obj/machinery/hydroponics/soil,
/obj/effect/turf_decal/weather/snow/corner{
	dir = 9
	},
/turf/open/floor/grass/fairy/icemoon,
/area/icemoon/underground/explored)
"ZR" = (
/obj/item/cultivator/rake,
/obj/effect/turf_decal/weather/snow/corner{
	dir = 8
	},
/turf/open/floor/grass/fairy/icemoon,
/area/icemoon/underground/explored)

(1,1,1) = {"
QD
QD
CR
CR
CR
CR
aM
dY
jY
Cz
Jc
aM
Cz
lN
Cz
aM
"}
(2,1,1) = {"
QD
CR
CR
ml
CR
CR
CR
tj
NP
il
il
Cd
il
il
il
Nw
"}
(3,1,1) = {"
CR
CR
CR
CR
CR
CR
aM
GI
Lf
il
Il
il
QN
Lh
il
cB
"}
(4,1,1) = {"
CR
pA
pA
pA
pA
pA
aM
GI
il
il
YA
Lz
Qz
Oc
il
kn
"}
(5,1,1) = {"
pA
pA
oo
LG
hN
pA
pA
Cx
zj
il
Lf
Qh
za
Oc
Lf
cB
"}
(6,1,1) = {"
pA
oo
oJ
Mp
oJ
mB
pA
aM
uw
zj
il
il
il
bo
il
cB
"}
(7,1,1) = {"
pA
Fs
BC
ii
eI
Fp
Uw
jY
aM
im
kr
zj
il
Eo
il
kn
"}
(8,1,1) = {"
pA
Zu
rA
Ys
yx
ph
pA
tj
aM
aM
TL
Cx
bu
il
il
cB
"}
(9,1,1) = {"
pA
pA
sC
sC
MN
pA
pA
aM
aM
uw
aM
jY
dY
kr
kr
dY
"}
(10,1,1) = {"
pA
zd
mF
qs
qs
bp
pA
pA
pA
aM
Cx
aM
aM
uw
aM
aM
"}
(11,1,1) = {"
pA
Le
cI
MR
DM
yG
Xl
XI
DP
aM
aM
aM
GI
Rr
jG
Rr
"}
(12,1,1) = {"
pA
ID
Si
QW
OL
JI
pA
pA
pA
Cx
Gm
aM
ch
Rr
ON
Rr
"}
(13,1,1) = {"
pA
SP
aT
Se
GH
yG
Uw
ZO
ZR
UH
Po
GI
il
Rr
et
Rr
"}
(14,1,1) = {"
pA
pA
Ey
sJ
Rd
yG
Uw
cZ
Vi
vy
wH
vf
il
aa
io
aa
"}
(15,1,1) = {"
QD
pA
pA
ha
DW
VD
pA
Dm
CU
aM
Dr
GI
il
il
il
cB
"}
(16,1,1) = {"
QD
QD
pA
pA
pA
pA
pA
pA
aM
dY
Cx
Cx
kr
hC
GS
Cx
"}
