//MAP CONVERTED BY dmm2tgm.py THIS HEADER COMMENT PREVENTS RECONVERSION, DO NOT REMOVE
"a" = (
/turf/template_noop,
/area/template_noop)
"A" = (
/obj/structure/cable,
/obj/effect/turf_decal/stripes/line{
	dir = 9
	},
/obj/effect/landmark/start/explorer,
/turf/open/floor/iron,
/area/station/command/gateway)
"C" = (
/obj/effect/decal/cleanable/dirt,
/obj/effect/turf_decal/stripes/line{
	dir = 8
	},
/obj/effect/landmark/start/explorer,
/turf/open/floor/iron,
/area/station/command/gateway)
"O" = (
/obj/structure/cable,
/obj/effect/turf_decal/stripes/line{
	dir = 4
	},
/obj/machinery/atmospherics/pipe/smart/manifold4w/supply/hidden/layer4,
/obj/machinery/atmospherics/pipe/smart/manifold4w/scrubbers/hidden/layer2,
/obj/effect/landmark/start/explorer,
/turf/open/floor/iron,
/area/station/command/gateway)

(1,1,1) = {"
A
a
C
"}
(2,1,1) = {"
a
a
a
"}
(3,1,1) = {"
a
O
a
"}
