//MAP CONVERTED BY dmm2tgm.py THIS HEADER COMMENT PREVENTS RECONVERSION, DO NOT REMOVE
"a" = (
/turf/template_noop,
/area/template_noop)
"b" = (
/turf/open/floor/engine,
/area/station/cargo/exploration_office)
"c" = (
/turf/open/space/basic,
/area/template_noop)
"d" = (
/obj/structure/sign/warning/doors/directional/east,
/turf/open/floor/catwalk_floor,
/area/space/nearstation)
"f" = (
/obj/machinery/suit_storage_unit/standard_unit,
/turf/open/floor/engine,
/area/station/cargo/exploration_office)
"g" = (
/obj/machinery/atmospherics/components/unary/vent_pump/on/layer4,
/turf/open/floor/engine,
/area/station/cargo/exploration_office)
"i" = (
/obj/effect/decal/cleanable/dirt,
/obj/machinery/atmospherics/pipe/smart/manifold4w/cyan/hidden,
/obj/machinery/atmospherics/pipe/smart/manifold4w/supply/hidden/layer4,
/obj/machinery/atmospherics/pipe/smart/manifold4w/supply/hidden/layer4,
/obj/machinery/atmospherics/pipe/smart/manifold4w/scrubbers/hidden/layer2,
/turf/open/floor/iron,
/area/station/hallway/secondary/entry)
"k" = (
/obj/machinery/power/apc/auto_name/directional/south,
/obj/structure/cable,
/obj/machinery/atmospherics/pipe/smart/manifold4w/scrubbers/hidden/layer2,
/obj/machinery/atmospherics/pipe/smart/manifold4w/cyan/hidden/layer4,
/turf/open/floor/engine,
/area/station/cargo/exploration_office)
"l" = (
/obj/structure/cable,
/turf/closed/wall,
/area/station/maintenance/port/fore)
"m" = (
/obj/effect/turf_decal/stripes/line,
/obj/effect/turf_decal/stripes/line{
	dir = 1
	},
/obj/machinery/door/airlock/external{
	name = "Exploration Office Airlock"
	},
/obj/effect/mapping_helpers/airlock/access/all/command/gateway,
/turf/open/floor/iron,
/area/station/cargo/exploration_office)
"n" = (
/obj/structure/sign/warning/vacuum/external/directional/south,
/obj/machinery/atmospherics/pipe/smart/manifold4w/scrubbers/hidden/layer2,
/obj/machinery/atmospherics/pipe/smart/manifold4w/cyan/hidden/layer4,
/turf/open/floor/engine,
/area/station/cargo/exploration_office)
"o" = (
/obj/structure/lattice,
/turf/open/space/basic,
/area/space/nearstation)
"p" = (
/obj/structure/rack,
/obj/machinery/airalarm/directional/south,
/turf/open/floor/engine,
/area/station/cargo/exploration_office)
"q" = (
/obj/structure/sign/warning/directional/south,
/turf/open/floor/catwalk_floor,
/area/space/nearstation)
"r" = (
/obj/effect/turf_decal/stripes/line,
/turf/open/floor/engine,
/area/station/cargo/exploration_office)
"s" = (
/obj/machinery/suit_storage_unit/standard_unit,
/obj/machinery/light_switch/directional/east,
/turf/open/floor/engine,
/area/station/cargo/exploration_office)
"t" = (
/obj/structure/cable,
/obj/machinery/atmospherics/pipe/smart/manifold4w/supply/hidden/layer4,
/obj/machinery/atmospherics/pipe/smart/manifold4w/scrubbers/hidden/layer2,
/obj/machinery/door/airlock/mining{
	name = "Exploration Office"
	},
/obj/effect/mapping_helpers/airlock/access/all/command/gateway,
/obj/machinery/atmospherics/pipe/smart/manifold4w/cyan/hidden,
/obj/machinery/atmospherics/pipe/smart/manifold4w/scrubbers/hidden/layer2,
/obj/machinery/atmospherics/pipe/smart/manifold4w/supply/hidden/layer4,
/turf/open/floor/iron,
/area/station/hallway/secondary/entry)
"u" = (
/obj/machinery/dive_anchor/stationary,
/obj/effect/turf_decal/stripes/box,
/turf/open/floor/engine,
/area/station/cargo/exploration_office)
"v" = (
/obj/structure/lattice,
/turf/closed/wall,
/area/station/cargo/exploration_office)
"w" = (
/obj/machinery/light/directional/west,
/obj/effect/turf_decal/stripes/line,
/obj/machinery/atmospherics/components/unary/vent_scrubber/on/layer2,
/turf/open/floor/engine,
/area/station/cargo/exploration_office)
"x" = (
/obj/structure/extinguisher_cabinet/directional/south,
/obj/structure/cable,
/obj/machinery/atmospherics/pipe/smart/manifold4w/scrubbers/hidden/layer2,
/obj/machinery/atmospherics/pipe/smart/manifold4w/cyan/hidden/layer4,
/turf/open/floor/engine,
/area/station/cargo/exploration_office)
"y" = (
/obj/effect/spawner/structure/window/reinforced,
/turf/open/floor/plating,
/area/station/cargo/exploration_office)
"z" = (
/obj/structure/chair/office{
	dir = 1
	},
/turf/open/floor/engine,
/area/station/cargo/exploration_office)
"A" = (
/obj/structure/cable,
/obj/machinery/atmospherics/pipe/smart/manifold4w/scrubbers/hidden/layer2,
/obj/machinery/atmospherics/pipe/smart/manifold4w/supply/hidden/layer4,
/obj/machinery/atmospherics/pipe/smart/manifold4w/cyan/hidden,
/turf/open/floor/engine,
/area/station/cargo/exploration_office)
"C" = (
/obj/effect/turf_decal/tile/neutral{
	dir = 1
	},
/obj/machinery/atmospherics/pipe/smart/manifold4w/cyan/hidden,
/obj/structure/cable,
/obj/machinery/atmospherics/pipe/smart/manifold4w/supply/hidden/layer4,
/obj/machinery/atmospherics/pipe/smart/manifold4w/scrubbers/hidden/layer2,
/turf/open/floor/iron,
/area/station/hallway/secondary/entry)
"D" = (
/turf/closed/wall,
/area/station/cargo/exploration_office)
"G" = (
/obj/effect/turf_decal/stripes/line,
/obj/effect/turf_decal/stripes/line{
	dir = 1
	},
/obj/machinery/door/airlock/external{
	name = "Exploration Office Airlock"
	},
/obj/machinery/atmospherics/pipe/smart/manifold4w/scrubbers/hidden/layer2,
/obj/machinery/atmospherics/pipe/smart/manifold4w/cyan/hidden/layer4,
/obj/effect/mapping_helpers/airlock/access/all/command/gateway,
/turf/open/floor/iron,
/area/station/cargo/exploration_office)
"H" = (
/obj/structure/cable,
/obj/machinery/atmospherics/pipe/smart/manifold4w/scrubbers/hidden/layer2,
/obj/machinery/atmospherics/pipe/layer_manifold/cyan/hidden{
	dir = 8
	},
/turf/open/floor/engine,
/area/station/cargo/exploration_office)
"J" = (
/obj/effect/turf_decal/stripes/line{
	dir = 4
	},
/turf/open/floor/engine,
/area/station/cargo/exploration_office)
"K" = (
/obj/effect/turf_decal/tile/neutral/half/contrasted{
	dir = 1
	},
/obj/machinery/atmospherics/pipe/smart/manifold4w/cyan/hidden,
/obj/machinery/meter,
/obj/structure/cable,
/turf/open/floor/iron,
/area/station/maintenance/port/fore)
"L" = (
/obj/machinery/light/directional/south,
/obj/structure/cable,
/obj/machinery/atmospherics/pipe/smart/manifold4w/scrubbers/hidden/layer2,
/turf/open/floor/engine,
/area/station/cargo/exploration_office)
"M" = (
/obj/machinery/dive_anchor,
/turf/open/space/basic,
/area/space/nearstation)
"O" = (
/obj/machinery/computer/anchor_controller,
/turf/open/floor/engine,
/area/station/cargo/exploration_office)
"P" = (
/turf/open/floor/catwalk_floor,
/area/space/nearstation)
"Q" = (
/turf/closed/wall,
/area/station/hallway/secondary/entry)
"S" = (
/obj/machinery/door/airlock{
	name = "Auxiliary Storage Closet"
	},
/obj/effect/turf_decal/stripes/line,
/obj/effect/turf_decal/stripes/line{
	dir = 1
	},
/obj/machinery/atmospherics/pipe/smart/manifold4w/cyan/hidden,
/obj/structure/cable,
/turf/open/floor/iron,
/area/station/maintenance/port/fore)
"T" = (
/obj/effect/turf_decal/stripes/line{
	dir = 6
	},
/obj/machinery/atmospherics/pipe/smart/manifold4w/cyan/hidden/layer4,
/turf/open/floor/engine,
/area/station/cargo/exploration_office)
"U" = (
/obj/docking_port/stationary{
	dir = 8;
	dwidth = 11;
	height = 24;
	name = "SS13: Auxiliary Dock, Station-Fore";
	shuttle_id = "whiteship_home";
	width = 35
	},
/turf/open/space/basic,
/area/template_noop)
"V" = (
/obj/structure/tank_dispenser/oxygen{
	pixel_y = 2;
	pixel_x = 2
	},
/turf/open/floor/engine,
/area/station/cargo/exploration_office)
"X" = (
/obj/effect/turf_decal/tile/neutral/anticorner/contrasted{
	dir = 4
	},
/obj/structure/closet/firecloset,
/obj/effect/turf_decal/bot,
/obj/structure/cable,
/turf/open/floor/iron,
/area/station/maintenance/port/fore)
"Y" = (
/obj/effect/turf_decal/stripes/line,
/obj/effect/turf_decal/stripes/line{
	dir = 1
	},
/obj/machinery/light/small/directional/south,
/obj/machinery/atmospherics/components/unary/airlock_pump{
	dir = 4
	},
/turf/open/floor/iron,
/area/station/cargo/exploration_office)
"Z" = (
/obj/effect/turf_decal/tile/neutral/opposingcorners,
/obj/machinery/atmospherics/pipe/smart/manifold4w/cyan/hidden,
/obj/structure/cable,
/turf/open/floor/iron,
/area/station/hallway/secondary/entry)

(1,1,1) = {"
a
a
a
a
a
a
a
a
a
a
a
a
a
a
a
a
a
a
a
a
a
"}
(2,1,1) = {"
a
a
a
a
a
a
a
a
a
a
a
a
a
a
a
a
a
a
a
a
a
"}
(3,1,1) = {"
a
a
a
a
a
a
a
a
a
a
a
a
a
P
P
P
P
P
d
o
a
"}
(4,1,1) = {"
a
a
a
a
a
a
a
a
a
a
a
a
a
P
M
q
D
m
D
o
a
"}
(5,1,1) = {"
a
a
a
a
a
a
a
a
a
a
a
a
a
P
P
P
D
Y
D
o
a
"}
(6,1,1) = {"
a
a
a
a
a
a
a
a
a
a
a
a
a
y
y
y
D
G
D
o
a
"}
(7,1,1) = {"
a
a
a
a
a
a
a
a
a
a
a
a
a
y
b
b
w
n
D
o
a
"}
(8,1,1) = {"
a
a
a
a
a
a
a
a
a
a
a
a
a
y
b
u
r
k
D
o
a
"}
(9,1,1) = {"
a
a
a
a
a
a
a
a
a
a
a
a
a
y
J
J
T
x
D
o
a
"}
(10,1,1) = {"
a
a
a
a
a
a
a
a
a
a
a
a
a
y
O
z
H
L
D
o
a
"}
(11,1,1) = {"
U
a
a
a
a
a
a
c
a
a
a
a
a
D
V
g
A
p
D
o
a
"}
(12,1,1) = {"
a
a
a
a
a
a
a
a
a
a
a
a
a
D
D
s
A
f
v
a
a
"}
(13,1,1) = {"
a
a
a
a
a
a
a
a
a
a
a
a
a
a
a
Q
t
Q
a
a
a
"}
(14,1,1) = {"
a
a
a
a
a
a
a
a
a
a
a
a
a
a
a
a
C
Z
S
K
a
"}
(15,1,1) = {"
a
a
a
a
a
a
a
a
a
a
a
a
a
a
a
a
i
a
a
X
a
"}
(16,1,1) = {"
a
a
a
a
a
a
a
a
a
a
a
a
a
a
a
a
a
a
a
l
a
"}
