//MAP CONVERTED BY dmm2tgm.py THIS HEADER COMMENT PREVENTS RECONVERSION, DO NOT REMOVE
"a" = (
/turf/template_noop,
/area/template_noop)
"c" = (
/obj/effect/turf_decal/stripes/line,
/turf/open/floor/iron/kitchen_coldroom/freezerfloor,
/area/station/service/kitchen/coldroom)
"f" = (
/obj/effect/turf_decal/bot,
/obj/structure/closet/secure_closet/freezer/kitchen,
/obj/item/reagent_containers/condiment/flour,
/obj/structure/disposalpipe/segment{
	dir = 4
	},
/obj/effect/turf_decal/tile/dark_green/opposingcorners,
/obj/effect/turf_decal/tile/dark_blue/opposingcorners{
	dir = 1
	},
/turf/open/floor/iron/kitchen_coldroom,
/area/station/service/kitchen/coldroom)
"i" = (
/obj/effect/turf_decal/bot,
/obj/structure/closet/secure_closet/freezer/meat,
/obj/item/food/meat/slab/monkey,
/obj/item/food/meat/slab/monkey,
/obj/structure/disposalpipe/segment{
	dir = 9
	},
/obj/effect/turf_decal/tile/dark_green/opposingcorners,
/obj/effect/turf_decal/tile/dark_blue/opposingcorners{
	dir = 1
	},
/turf/open/floor/iron/kitchen_coldroom,
/area/station/service/kitchen/coldroom)
"k" = (
/obj/effect/turf_decal/stripes/line{
	dir = 1
	},
/obj/effect/decal/cleanable/dirt,
/turf/open/floor/iron/kitchen_coldroom/freezerfloor,
/area/station/service/kitchen/coldroom)
"l" = (
/obj/structure/reagent_dispensers/cooking_oil,
/obj/effect/turf_decal/tile/dark_green/opposingcorners,
/obj/effect/turf_decal/tile/dark_blue/opposingcorners{
	dir = 1
	},
/turf/open/floor/iron/kitchen_coldroom,
/area/station/service/kitchen/coldroom)
"p" = (
/obj/effect/turf_decal/siding/white,
/obj/structure/disposalpipe/segment,
/obj/machinery/light/small/directional/east,
/obj/item/radio/intercom/directional/east,
/turf/open/floor/iron/kitchen_coldroom/freezerfloor,
/area/station/service/kitchen/coldroom)
"q" = (
/obj/effect/turf_decal/stripes/corner{
	dir = 1
	},
/obj/effect/turf_decal/siding/white,
/obj/structure/cable,
/obj/machinery/atmospherics/components/unary/vent_scrubber/on/layer2{
	dir = 8
	},
/obj/effect/decal/cleanable/food/flour,
/turf/open/floor/iron/kitchen_coldroom/freezerfloor,
/area/station/service/kitchen/coldroom)
"r" = (
/obj/effect/turf_decal/stripes/corner,
/obj/machinery/atmospherics/components/unary/vent_pump/on/layer4,
/obj/machinery/light/small/directional/west,
/obj/effect/decal/cleanable/dirt,
/turf/open/floor/iron/kitchen_coldroom/freezerfloor,
/area/station/service/kitchen/coldroom)
"s" = (
/obj/effect/turf_decal/bot,
/obj/structure/closet/secure_closet/freezer/fridge,
/obj/item/storage/fancy/egg_box,
/obj/item/storage/fancy/egg_box,
/obj/item/reagent_containers/condiment/milk,
/obj/item/reagent_containers/condiment/milk,
/obj/item/reagent_containers/condiment/soymilk,
/obj/structure/disposalpipe/segment{
	dir = 4
	},
/obj/machinery/power/apc/auto_name/directional/south,
/obj/structure/cable,
/obj/effect/turf_decal/tile/dark_green/opposingcorners,
/obj/effect/turf_decal/tile/dark_blue/opposingcorners{
	dir = 1
	},
/turf/open/floor/iron/kitchen_coldroom,
/area/station/service/kitchen/coldroom)
"t" = (
/obj/effect/turf_decal/stripes/line{
	dir = 8
	},
/obj/effect/landmark/event_spawn,
/turf/open/floor/iron/kitchen_coldroom/freezerfloor,
/area/station/service/kitchen/coldroom)
"w" = (
/obj/effect/turf_decal/stripes/line{
	dir = 4
	},
/obj/structure/sink/kitchen/directional/south,
/turf/open/floor/iron/kitchen_coldroom/freezerfloor,
/area/station/service/kitchen/coldroom)
"y" = (
/obj/effect/turf_decal/stripes/corner{
	dir = 8
	},
/obj/effect/mapping_helpers/airalarm/tlv_cold_room,
/obj/machinery/airalarm/directional/north,
/turf/open/floor/iron/kitchen_coldroom/freezerfloor,
/area/station/service/kitchen/coldroom)
"A" = (
/obj/effect/mapping_helpers/airlock/access/all/service/kitchen,
/obj/structure/fans/tiny,
/obj/structure/disposalpipe/segment,
/obj/effect/turf_decal/stripes/line,
/obj/effect/turf_decal/stripes/line{
	dir = 1
	},
/obj/machinery/duct,
/obj/machinery/door/airlock/freezer{
	name = "Coldroom"
	},
/turf/open/floor/iron/kitchen_coldroom/freezerfloor,
/area/station/service/kitchen/coldroom)
"C" = (
/obj/effect/turf_decal/bot/right,
/obj/structure/kitchenspike,
/obj/effect/turf_decal/tile/dark_green/opposingcorners,
/obj/effect/turf_decal/tile/dark_blue/opposingcorners{
	dir = 1
	},
/turf/open/floor/iron/kitchen_coldroom,
/area/station/service/kitchen/coldroom)
"E" = (
/obj/machinery/door/window/right/directional/north{
	name = "Kitchen Delivery";
	req_access = list("kitchen")
	},
/obj/structure/window/reinforced/spawner/directional/east,
/obj/effect/turf_decal/delivery,
/obj/structure/disposalpipe/segment{
	dir = 4
	},
/obj/effect/decal/cleanable/dirt,
/turf/open/floor/iron/kitchen_coldroom/freezerfloor,
/area/station/service/kitchen/coldroom)
"H" = (
/obj/machinery/gibber,
/obj/effect/turf_decal/tile/dark_blue/opposingcorners{
	dir = 1
	},
/obj/effect/turf_decal/tile/dark_green/opposingcorners,
/turf/open/floor/iron/kitchen_coldroom,
/area/station/service/kitchen/coldroom)
"I" = (
/obj/effect/turf_decal/stripes/line{
	dir = 1
	},
/turf/open/floor/iron/kitchen_coldroom/freezerfloor,
/area/station/service/kitchen/coldroom)
"J" = (
/obj/effect/turf_decal/stripes/line{
	dir = 4
	},
/obj/machinery/atmospherics/pipe/smart/manifold4w/supply/hidden/layer4,
/obj/structure/extinguisher_cabinet/directional/west,
/obj/machinery/camera/directional/west{
	c_tag = "Service - Kitchen Coldroom";
	dir = 10;
	name = "service camera"
	},
/turf/open/floor/iron/kitchen_coldroom/freezerfloor,
/area/station/service/kitchen/coldroom)
"K" = (
/obj/machinery/atmospherics/components/unary/thermomachine/freezer/on/coldroom{
	dir = 8
	},
/obj/effect/turf_decal/tile/dark_green/opposingcorners,
/obj/effect/turf_decal/tile/dark_blue/opposingcorners{
	dir = 1
	},
/turf/open/floor/iron/kitchen_coldroom,
/area/station/service/kitchen/coldroom)
"O" = (
/obj/effect/mapping_helpers/airlock/access/all/service/kitchen,
/obj/structure/fans/tiny,
/obj/structure/cable,
/obj/machinery/atmospherics/pipe/smart/manifold4w/scrubbers/hidden/layer2,
/obj/machinery/atmospherics/pipe/smart/manifold4w/supply/hidden/layer4,
/obj/effect/turf_decal/stripes/line{
	dir = 8
	},
/obj/effect/turf_decal/stripes/line{
	dir = 4
	},
/obj/machinery/door/airlock/maintenance_hatch{
	name = "Kitchen Coldroom"
	},
/turf/open/floor/iron/kitchen_coldroom/freezerfloor,
/area/station/maintenance/port/fore)
"Q" = (
/obj/effect/turf_decal/stripes/line{
	dir = 4
	},
/obj/machinery/atmospherics/components/unary/passive_vent{
	dir = 4
	},
/obj/machinery/duct,
/obj/effect/decal/cleanable/dirt,
/turf/open/floor/iron/kitchen_coldroom/freezerfloor,
/area/station/service/kitchen/coldroom)
"U" = (
/obj/machinery/duct,
/obj/structure/disposalpipe/segment,
/mob/living/basic/goat/pete,
/obj/effect/decal/cleanable/dirt,
/turf/open/floor/iron/kitchen_coldroom/freezerfloor,
/area/station/service/kitchen/coldroom)
"V" = (
/obj/machinery/duct,
/obj/structure/disposalpipe/segment,
/turf/open/floor/iron/kitchen_coldroom/freezerfloor,
/area/station/service/kitchen/coldroom)
"X" = (
/obj/effect/turf_decal/stripes/line{
	dir = 1
	},
/obj/effect/turf_decal/siding/white,
/obj/structure/cable,
/obj/machinery/atmospherics/pipe/smart/manifold4w/scrubbers/hidden/layer2,
/turf/open/floor/iron/kitchen_coldroom/freezerfloor,
/area/station/service/kitchen/coldroom)
"Y" = (
/obj/effect/turf_decal/stripes/corner{
	dir = 4
	},
/obj/effect/turf_decal/siding/white/corner,
/obj/structure/cable,
/obj/machinery/atmospherics/pipe/smart/manifold4w/scrubbers/hidden/layer2,
/obj/machinery/atmospherics/pipe/smart/manifold4w/supply/hidden/layer4,
/turf/open/floor/iron/kitchen_coldroom/freezerfloor,
/area/station/service/kitchen/coldroom)
"Z" = (
/obj/effect/turf_decal/bot/left,
/obj/structure/kitchenspike,
/obj/effect/turf_decal/tile/dark_green/opposingcorners,
/obj/effect/turf_decal/tile/dark_blue/opposingcorners{
	dir = 1
	},
/turf/open/floor/iron/kitchen_coldroom,
/area/station/service/kitchen/coldroom)

(1,1,1) = {"
a
a
a
a
O
a
"}
(2,1,1) = {"
C
I
r
J
Y
E
"}
(3,1,1) = {"
Z
k
c
H
X
f
"}
(4,1,1) = {"
a
a
y
t
q
s
"}
(5,1,1) = {"
a
A
V
U
p
i
"}
(6,1,1) = {"
a
a
w
Q
a
a
"}
(7,1,1) = {"
a
a
l
K
a
a
"}
