//MAP CONVERTED BY dmm2tgm.py THIS HEADER COMMENT PREVENTS RECONVERSION, DO NOT REMOVE
"a" = (
/obj/effect/turf_decal/stripes/line{
	dir = 8
	},
/obj/structure/disposalpipe/segment{
	dir = 9
	},
/obj/machinery/atmospherics/pipe/smart/manifold4w/scrubbers/hidden/layer2,
/obj/machinery/atmospherics/pipe/smart/manifold4w/supply/hidden/layer4,
/obj/structure/cable,
/obj/effect/landmark/start/bitrunner,
/turf/open/floor/iron/herringbone,
/area/station/cargo/miningoffice)
"h" = (
/obj/effect/turf_decal/stripes/line{
	dir = 8
	},
/obj/structure/disposalpipe/segment,
/obj/machinery/atmospherics/pipe/smart/manifold4w/scrubbers/hidden/layer2,
/obj/machinery/atmospherics/pipe/smart/manifold4w/supply/hidden/layer4,
/obj/structure/cable,
/turf/open/floor/iron/herringbone,
/area/station/cargo/miningoffice)
"q" = (
/obj/machinery/conveyor_switch/oneway{
	id = "mining";
	dir = 1
	},
/obj/structure/railing{
	dir = 10
	},
/obj/effect/turf_decal/stripes/end{
	dir = 8
	},
/obj/structure/disposalpipe/segment{
	dir = 9
	},
/obj/machinery/atmospherics/components/unary/vent_scrubber/on/layer2{
	dir = 4
	},
/turf/open/floor/iron/herringbone,
/area/station/cargo/miningoffice)
"r" = (
/obj/machinery/conveyor{
	dir = 4;
	id = "mining"
	},
/obj/machinery/bouldertech/refinery/smelter,
/obj/structure/disposalpipe/segment,
/turf/open/floor/iron/herringbone,
/area/station/cargo/miningoffice)
"u" = (
/obj/machinery/conveyor{
	dir = 5;
	id = "mining"
	},
/obj/machinery/light/directional/west,
/obj/structure/sign/poster/official/random/directional/west,
/obj/effect/turf_decal/tile/brown/half{
	dir = 8
	},
/turf/open/floor/iron/half{
	dir = 1
	},
/area/station/cargo/miningoffice)
"w" = (
/obj/machinery/conveyor{
	dir = 1;
	id = "mining"
	},
/obj/machinery/bouldertech/refinery,
/obj/structure/disposalpipe/segment{
	dir = 4
	},
/obj/effect/turf_decal/tile/brown/half{
	dir = 8
	},
/turf/open/floor/iron/half{
	dir = 1
	},
/area/station/cargo/miningoffice)
"A" = (
/obj/machinery/conveyor{
	dir = 8;
	id = "mining"
	},
/obj/machinery/brm,
/obj/structure/disposalpipe/segment{
	dir = 4
	},
/turf/open/floor/iron/herringbone,
/area/station/cargo/miningoffice)
"J" = (
/turf/template_noop,
/area/template_noop)
"L" = (
/obj/machinery/conveyor{
	dir = 9;
	id = "mining"
	},
/obj/structure/disposalpipe/segment{
	dir = 4
	},
/obj/effect/turf_decal/tile/brown/half{
	dir = 8
	},
/turf/open/floor/iron/half{
	dir = 1
	},
/area/station/cargo/miningoffice)
"Q" = (
/obj/effect/spawner/structure/window/reinforced,
/obj/structure/disposalpipe/segment,
/turf/open/floor/plating,
/area/station/cargo/miningoffice)
"T" = (
/obj/effect/turf_decal/stripes/corner{
	dir = 1
	},
/obj/effect/turf_decal/stripes/corner{
	dir = 8
	},
/obj/structure/disposalpipe/segment,
/obj/machinery/atmospherics/pipe/smart/manifold4w/scrubbers/hidden/layer2,
/obj/machinery/atmospherics/pipe/smart/manifold4w/supply/hidden/layer4,
/obj/structure/cable,
/obj/effect/landmark/start/bitrunner,
/turf/open/floor/iron/herringbone,
/area/station/cargo/miningoffice)

(1,1,1) = {"
J
J
J
J
J
J
"}
(2,1,1) = {"
J
J
u
w
L
J
"}
(3,1,1) = {"
J
Q
r
q
A
J
"}
(4,1,1) = {"
J
J
h
T
a
J
"}
(5,1,1) = {"
J
J
J
J
J
J
"}
(6,1,1) = {"
J
J
J
J
J
J
"}
