//MAP CONVERTED BY dmm2tgm.py THIS HEADER COMMENT PREVENTS RECONVERSION, DO NOT REMOVE
"a" = (
/turf/closed/wall,
/area/station/cargo/exploration_office)
"b" = (
/obj/structure/sign/warning/doors/directional/east,
/obj/structure/lattice/catwalk,
/turf/open/space/basic,
/area/space/nearstation)
"c" = (
/obj/machinery/suit_storage_unit/standard_unit,
/obj/machinery/light_switch/directional/east,
/turf/open/floor/engine,
/area/station/cargo/exploration_office)
"d" = (
/turf/open/space/basic,
/area/template_noop)
"e" = (
/turf/open/floor/engine,
/area/station/cargo/exploration_office)
"f" = (
/obj/effect/turf_decal/tile/neutral/opposingcorners,
/obj/machinery/atmospherics/pipe/smart/manifold4w/cyan/hidden,
/obj/structure/cable,
/turf/open/floor/iron,
/area/station/hallway/secondary/entry)
"g" = (
/obj/machinery/door/airlock{
	name = "Auxiliary Storage Closet"
	},
/obj/effect/turf_decal/stripes/line,
/obj/effect/turf_decal/stripes/line{
	dir = 1
	},
/obj/machinery/atmospherics/pipe/smart/manifold4w/cyan/hidden,
/obj/structure/cable,
/turf/open/floor/iron,
/area/station/maintenance/port/fore)
"h" = (
/obj/structure/tank_dispenser/oxygen{
	pixel_y = 2;
	pixel_x = 2
	},
/turf/open/floor/engine,
/area/station/cargo/exploration_office)
"j" = (
/obj/machinery/dive_anchor,
/turf/open/space/basic,
/area/space/nearstation)
"k" = (
/obj/structure/cable,
/obj/machinery/atmospherics/pipe/smart/manifold4w/scrubbers/hidden/layer2,
/obj/machinery/atmospherics/pipe/smart/manifold4w/supply/hidden/layer4,
/obj/machinery/atmospherics/pipe/smart/manifold4w/cyan/hidden,
/turf/open/floor/engine,
/area/station/cargo/exploration_office)
"l" = (
/turf/closed/wall,
/area/station/hallway/secondary/entry)
"m" = (
/obj/effect/turf_decal/stripes/line,
/turf/open/floor/engine,
/area/station/cargo/exploration_office)
"n" = (
/obj/machinery/atmospherics/components/unary/vent_pump/on/layer4,
/obj/machinery/atmospherics/pipe/smart/manifold4w/cyan/hidden,
/turf/open/floor/engine,
/area/station/cargo/exploration_office)
"o" = (
/obj/structure/rack,
/obj/machinery/airalarm/directional/south,
/obj/item/multitool,
/obj/item/stack/impure_telecrystal,
/obj/item/stack/rods/twentyfive,
/turf/open/floor/engine,
/area/station/cargo/exploration_office)
"p" = (
/obj/structure/sign/warning/vacuum/external/directional/south,
/obj/machinery/atmospherics/pipe/smart/manifold4w/scrubbers/hidden/layer2,
/obj/machinery/atmospherics/pipe/smart/manifold4w/cyan/hidden/layer4,
/turf/open/floor/engine,
/area/station/cargo/exploration_office)
"q" = (
/obj/effect/turf_decal/stripes/line{
	dir = 4
	},
/obj/machinery/atmospherics/pipe/smart/manifold4w/cyan/hidden/layer4,
/turf/open/floor/engine,
/area/station/cargo/exploration_office)
"r" = (
/obj/effect/landmark/start/explorer,
/turf/open/floor/engine,
/area/station/cargo/exploration_office)
"s" = (
/obj/structure/cable,
/turf/closed/wall,
/area/station/maintenance/port/fore)
"u" = (
/obj/structure/cable,
/obj/machinery/atmospherics/pipe/smart/manifold4w/scrubbers/hidden/layer2,
/turf/open/floor/engine,
/area/station/cargo/exploration_office)
"v" = (
/obj/structure/lattice/catwalk,
/turf/open/space/basic,
/area/space/nearstation)
"w" = (
/obj/effect/turf_decal/tile/neutral/anticorner/contrasted{
	dir = 4
	},
/obj/structure/closet/firecloset,
/obj/effect/turf_decal/bot,
/obj/structure/cable,
/turf/open/floor/iron,
/area/station/maintenance/port/fore)
"z" = (
/obj/docking_port/stationary{
	dir = 8;
	dwidth = 11;
	height = 24;
	name = "SS13: Auxiliary Dock, Station-Fore";
	shuttle_id = "whiteship_home";
	width = 35
	},
/turf/open/space/basic,
/area/template_noop)
"A" = (
/obj/effect/turf_decal/tile/neutral{
	dir = 1
	},
/obj/machinery/atmospherics/pipe/smart/manifold4w/cyan/hidden,
/obj/structure/cable,
/obj/machinery/atmospherics/pipe/smart/manifold4w/supply/hidden/layer4,
/obj/machinery/atmospherics/pipe/smart/manifold4w/scrubbers/hidden/layer2,
/turf/open/floor/iron,
/area/station/hallway/secondary/entry)
"C" = (
/obj/effect/turf_decal/stripes/line,
/obj/effect/turf_decal/stripes/line{
	dir = 1
	},
/obj/machinery/light/small/directional/south,
/obj/machinery/atmospherics/components/unary/airlock_pump{
	dir = 4
	},
/turf/open/floor/iron,
/area/station/cargo/exploration_office)
"D" = (
/obj/effect/turf_decal/stripes/line{
	dir = 4
	},
/turf/open/floor/engine,
/area/station/cargo/exploration_office)
"E" = (
/obj/machinery/dive_anchor/stationary,
/obj/effect/turf_decal/stripes/box,
/turf/open/floor/engine,
/area/station/cargo/exploration_office)
"F" = (
/obj/machinery/suit_storage_unit/standard_unit,
/obj/machinery/firealarm/directional/east,
/turf/open/floor/engine,
/area/station/cargo/exploration_office)
"G" = (
/obj/effect/turf_decal/stripes/line{
	dir = 6
	},
/obj/machinery/atmospherics/pipe/smart/manifold4w/cyan/hidden/layer4,
/turf/open/floor/engine,
/area/station/cargo/exploration_office)
"H" = (
/turf/template_noop,
/area/template_noop)
"J" = (
/obj/structure/chair/office{
	dir = 1
	},
/obj/effect/landmark/start/explorer,
/obj/machinery/atmospherics/pipe/layer_manifold/cyan/hidden{
	dir = 8
	},
/turf/open/floor/engine,
/area/station/cargo/exploration_office)
"K" = (
/obj/effect/turf_decal/tile/neutral/half/contrasted{
	dir = 1
	},
/obj/machinery/atmospherics/pipe/smart/manifold4w/cyan/hidden,
/obj/machinery/meter,
/obj/structure/cable,
/turf/open/floor/iron,
/area/station/maintenance/port/fore)
"M" = (
/obj/machinery/light/directional/west,
/obj/effect/turf_decal/stripes/line,
/obj/machinery/atmospherics/components/unary/vent_scrubber/on/layer2,
/turf/open/floor/engine,
/area/station/cargo/exploration_office)
"N" = (
/obj/effect/spawner/structure/window/reinforced,
/turf/open/floor/plating,
/area/station/cargo/exploration_office)
"O" = (
/obj/structure/extinguisher_cabinet/directional/south,
/obj/structure/cable,
/obj/machinery/atmospherics/pipe/smart/manifold4w/scrubbers/hidden/layer2,
/obj/machinery/atmospherics/pipe/smart/manifold4w/cyan/hidden/layer4,
/obj/effect/landmark/start/explorer,
/turf/open/floor/engine,
/area/station/cargo/exploration_office)
"P" = (
/obj/effect/decal/cleanable/dirt,
/obj/machinery/atmospherics/pipe/smart/manifold4w/cyan/hidden,
/obj/machinery/atmospherics/pipe/smart/manifold4w/supply/hidden/layer4,
/obj/machinery/atmospherics/pipe/smart/manifold4w/supply/hidden/layer4,
/obj/machinery/atmospherics/pipe/smart/manifold4w/scrubbers/hidden/layer2,
/turf/open/floor/iron,
/area/station/hallway/secondary/entry)
"Q" = (
/obj/machinery/power/apc/auto_name/directional/south,
/obj/structure/cable,
/obj/machinery/atmospherics/pipe/smart/manifold4w/scrubbers/hidden/layer2,
/obj/machinery/atmospherics/pipe/smart/manifold4w/cyan/hidden/layer4,
/turf/open/floor/engine,
/area/station/cargo/exploration_office)
"R" = (
/obj/machinery/light/directional/south,
/obj/structure/cable,
/obj/machinery/atmospherics/pipe/smart/manifold4w/scrubbers/hidden/layer2,
/obj/item/kirbyplants/random,
/turf/open/floor/engine,
/area/station/cargo/exploration_office)
"S" = (
/obj/effect/turf_decal/stripes/line,
/obj/effect/turf_decal/stripes/line{
	dir = 1
	},
/obj/machinery/door/airlock/external{
	name = "Exploration Office Airlock"
	},
/obj/machinery/atmospherics/pipe/smart/manifold4w/scrubbers/hidden/layer2,
/obj/machinery/atmospherics/pipe/smart/manifold4w/cyan/hidden/layer4,
/obj/effect/mapping_helpers/airlock/access/all/command/gateway,
/turf/open/floor/iron,
/area/station/cargo/exploration_office)
"U" = (
/obj/structure/cable,
/obj/machinery/atmospherics/pipe/smart/manifold4w/supply/hidden/layer4,
/obj/machinery/atmospherics/pipe/smart/manifold4w/scrubbers/hidden/layer2,
/obj/machinery/door/airlock/mining{
	name = "Exploration Office"
	},
/obj/effect/mapping_helpers/airlock/access/all/command/gateway,
/obj/machinery/atmospherics/pipe/smart/manifold4w/cyan/hidden,
/obj/machinery/atmospherics/pipe/smart/manifold4w/scrubbers/hidden/layer2,
/obj/machinery/atmospherics/pipe/smart/manifold4w/supply/hidden/layer4,
/obj/machinery/door/firedoor,
/turf/open/floor/iron,
/area/station/cargo/exploration_office)
"V" = (
/obj/structure/sign/warning/directional/south,
/obj/structure/lattice/catwalk,
/turf/open/space/basic,
/area/space/nearstation)
"X" = (
/obj/structure/lattice,
/turf/open/space/basic,
/area/space/nearstation)
"Y" = (
/obj/effect/turf_decal/stripes/line,
/obj/effect/turf_decal/stripes/line{
	dir = 1
	},
/obj/machinery/door/airlock/external{
	name = "Exploration Office Airlock"
	},
/obj/effect/mapping_helpers/airlock/access/all/command/gateway,
/turf/open/floor/iron,
/area/station/cargo/exploration_office)
"Z" = (
/obj/machinery/computer/anchor_controller,
/turf/open/floor/engine,
/area/station/cargo/exploration_office)

(1,1,1) = {"
H
H
H
H
H
H
H
H
H
H
H
H
H
H
H
H
H
H
H
H
H
"}
(2,1,1) = {"
H
H
H
H
H
H
H
H
H
H
H
H
H
H
H
H
H
H
H
H
H
"}
(3,1,1) = {"
H
H
H
H
H
H
H
H
H
H
H
H
H
v
v
v
v
v
b
X
H
"}
(4,1,1) = {"
H
H
H
H
H
H
H
H
H
H
H
H
H
v
j
V
a
Y
a
X
H
"}
(5,1,1) = {"
H
H
H
H
H
H
H
H
H
H
H
H
H
v
v
v
a
C
a
X
H
"}
(6,1,1) = {"
H
H
H
H
H
H
H
H
H
H
H
H
H
N
N
N
a
S
a
X
H
"}
(7,1,1) = {"
H
H
H
H
H
H
H
H
H
H
H
H
H
N
e
e
M
p
a
X
H
"}
(8,1,1) = {"
H
H
H
H
H
H
H
H
H
H
H
H
H
N
r
E
m
Q
a
X
H
"}
(9,1,1) = {"
H
H
H
H
H
H
H
H
H
H
H
H
H
N
D
q
G
O
a
X
H
"}
(10,1,1) = {"
H
H
H
H
H
H
H
H
H
H
H
H
H
N
Z
J
u
R
a
X
H
"}
(11,1,1) = {"
z
H
H
H
H
H
H
d
H
H
H
H
H
a
h
n
k
o
a
X
H
"}
(12,1,1) = {"
H
H
H
H
H
H
H
H
H
H
H
H
H
a
a
c
k
F
a
H
H
"}
(13,1,1) = {"
H
H
H
H
H
H
H
H
H
H
H
H
H
H
H
l
U
l
H
H
H
"}
(14,1,1) = {"
H
H
H
H
H
H
H
H
H
H
H
H
H
H
H
H
A
f
g
K
H
"}
(15,1,1) = {"
H
H
H
H
H
H
H
H
H
H
H
H
H
H
H
H
P
H
H
w
H
"}
(16,1,1) = {"
H
H
H
H
H
H
H
H
H
H
H
H
H
H
H
H
H
H
H
s
H
"}
