//MAP CONVERTED BY dmm2tgm.py THIS HEADER COMMENT PREVENTS RECONVERSION, DO NOT REMOVE
"cf" = (
/obj/effect/landmark/start/explorer,
/obj/effect/turf_decal/stripes/line{
	dir = 1
	},
/turf/open/floor/engine,
/area/station/cargo/exploration_office)
"cg" = (
/turf/open/space/basic,
/area/template_noop)
"dC" = (
/obj/machinery/door/airlock{
	name = "Auxiliary Storage Closet"
	},
/obj/effect/turf_decal/stripes/line,
/obj/effect/turf_decal/stripes/line{
	dir = 1
	},
/obj/machinery/atmospherics/pipe/smart/manifold4w/cyan/hidden,
/obj/structure/cable,
/turf/open/floor/iron,
/area/station/maintenance/port/fore)
"fd" = (
/obj/structure/lattice/catwalk,
/obj/structure/marker_beacon/indigo{
	pixel_x = -12;
	pixel_y = -12
	},
/obj/structure/railing{
	dir = 1
	},
/turf/open/space/basic,
/area/space/nearstation)
"fm" = (
/obj/effect/turf_decal/stripes/line{
	dir = 6
	},
/obj/machinery/atmospherics/pipe/smart/manifold4w/cyan/hidden/layer4,
/turf/open/floor/engine,
/area/station/cargo/exploration_office)
"go" = (
/obj/machinery/suit_storage_unit/explorer,
/obj/machinery/light_switch/directional/east,
/obj/effect/turf_decal/bot,
/obj/effect/decal/cleanable/cobweb/cobweb2,
/turf/open/floor/iron,
/area/station/cargo/exploration_office)
"hL" = (
/obj/machinery/suit_storage_unit/explorer,
/obj/machinery/firealarm/directional/east,
/obj/effect/turf_decal/bot,
/turf/open/floor/iron,
/area/station/cargo/exploration_office)
"iH" = (
/obj/effect/decal/cleanable/dirt,
/obj/machinery/atmospherics/pipe/smart/manifold4w/cyan/hidden,
/obj/machinery/atmospherics/pipe/smart/manifold4w/supply/hidden/layer4,
/obj/machinery/atmospherics/pipe/smart/manifold4w/scrubbers/hidden/layer2,
/turf/open/floor/iron,
/area/station/hallway/secondary/entry)
"iQ" = (
/obj/structure/lattice/catwalk,
/obj/structure/marker_beacon/indigo{
	pixel_x = 14;
	pixel_y = -12
	},
/turf/open/space/basic,
/area/space/nearstation)
"jY" = (
/obj/structure/lattice/catwalk,
/obj/structure/marker_beacon/indigo{
	pixel_x = -12;
	pixel_y = 15
	},
/turf/open/space/basic,
/area/space/nearstation)
"kj" = (
/obj/machinery/light/directional/west,
/obj/machinery/atmospherics/components/unary/vent_scrubber/on/layer2,
/obj/effect/turf_decal/stripes/line{
	dir = 10
	},
/turf/open/floor/engine,
/area/station/cargo/exploration_office)
"ly" = (
/obj/structure/tank_dispenser/oxygen{
	pixel_y = 2;
	pixel_x = 2
	},
/obj/machinery/camera/autoname/directional/north,
/turf/open/floor/iron,
/area/station/cargo/exploration_office)
"mO" = (
/obj/machinery/airalarm/directional/south,
/obj/structure/table/reinforced,
/obj/machinery/recharger{
	pixel_x = -9;
	pixel_y = 7
	},
/obj/machinery/cell_charger{
	pixel_x = 3
	},
/turf/open/floor/iron,
/area/station/cargo/exploration_office)
"pb" = (
/obj/structure/cable,
/obj/machinery/atmospherics/pipe/smart/manifold4w/scrubbers/hidden/layer2,
/turf/open/floor/iron,
/area/station/cargo/exploration_office)
"pp" = (
/obj/effect/turf_decal/tile/neutral{
	dir = 1
	},
/obj/machinery/atmospherics/pipe/smart/manifold4w/cyan/hidden,
/obj/structure/cable,
/obj/machinery/atmospherics/pipe/smart/manifold4w/supply/hidden/layer4,
/obj/machinery/atmospherics/pipe/smart/manifold4w/scrubbers/hidden/layer2,
/turf/open/floor/iron,
/area/station/hallway/secondary/entry)
"pO" = (
/obj/effect/turf_decal/stripes/line,
/obj/effect/turf_decal/stripes/line{
	dir = 1
	},
/obj/machinery/door/airlock/external{
	name = "Exploration Office Airlock"
	},
/obj/effect/mapping_helpers/airlock/access/all/command/gateway,
/obj/effect/mapping_helpers/airlock/cyclelink_helper{
	dir = 4
	},
/turf/open/floor/iron,
/area/station/cargo/exploration_office)
"pS" = (
/obj/structure/lattice/catwalk,
/obj/structure/railing{
	dir = 8
	},
/turf/open/space/basic,
/area/space/nearstation)
"sw" = (
/obj/effect/turf_decal/tile/neutral/anticorner/contrasted{
	dir = 4
	},
/obj/structure/closet/firecloset,
/obj/effect/turf_decal/bot,
/obj/structure/cable,
/turf/open/floor/iron,
/area/station/maintenance/port/fore)
"sT" = (
/obj/effect/turf_decal/stripes/line,
/obj/effect/turf_decal/stripes/line{
	dir = 1
	},
/obj/machinery/door/airlock/external{
	name = "Exploration Office Airlock"
	},
/obj/machinery/atmospherics/pipe/smart/manifold4w/scrubbers/hidden/layer2,
/obj/machinery/atmospherics/pipe/smart/manifold4w/cyan/hidden/layer4,
/obj/effect/mapping_helpers/airlock/access/all/command/gateway,
/obj/effect/mapping_helpers/airlock/cyclelink_helper{
	dir = 8
	},
/turf/open/floor/iron,
/area/station/cargo/exploration_office)
"td" = (
/obj/machinery/dive_anchor,
/turf/open/space/basic,
/area/space/nearstation)
"tk" = (
/turf/template_noop,
/area/template_noop)
"tt" = (
/turf/closed/wall,
/area/station/cargo/exploration_office)
"ve" = (
/obj/structure/lattice,
/turf/open/space/basic,
/area/space/nearstation)
"vv" = (
/obj/structure/sign/warning/vacuum/external/directional/south,
/obj/machinery/atmospherics/pipe/smart/manifold4w/scrubbers/hidden/layer2,
/obj/machinery/atmospherics/pipe/smart/manifold4w/cyan/hidden/layer4,
/turf/open/floor/iron,
/area/station/cargo/exploration_office)
"wc" = (
/obj/structure/lattice/catwalk,
/obj/structure/railing/corner/end,
/turf/open/space/basic,
/area/space/nearstation)
"wn" = (
/obj/effect/turf_decal/stripes/line{
	dir = 8
	},
/turf/open/floor/engine,
/area/station/cargo/exploration_office)
"ww" = (
/obj/structure/cable,
/obj/machinery/atmospherics/pipe/smart/manifold4w/scrubbers/hidden/layer2,
/obj/machinery/atmospherics/pipe/smart/manifold4w/supply/hidden/layer4,
/obj/machinery/atmospherics/pipe/smart/manifold4w/cyan/hidden,
/turf/open/floor/iron,
/area/station/cargo/exploration_office)
"xw" = (
/obj/effect/turf_decal/stripes/line,
/obj/effect/turf_decal/stripes/line{
	dir = 1
	},
/obj/machinery/light/small/directional/south,
/obj/machinery/atmospherics/components/unary/airlock_pump{
	dir = 4
	},
/turf/open/floor/iron,
/area/station/cargo/exploration_office)
"xz" = (
/obj/effect/turf_decal/tile/neutral/opposingcorners,
/obj/machinery/atmospherics/pipe/smart/manifold4w/cyan/hidden,
/obj/structure/cable,
/turf/open/floor/iron,
/area/station/hallway/secondary/entry)
"AK" = (
/turf/closed/wall,
/area/station/hallway/secondary/entry)
"BE" = (
/obj/structure/lattice/catwalk,
/obj/structure/railing/corner/end/flip{
	dir = 4
	},
/turf/open/space/basic,
/area/space/nearstation)
"BQ" = (
/obj/machinery/computer/anchor_controller,
/turf/open/floor/iron,
/area/station/cargo/exploration_office)
"CS" = (
/obj/structure/cable,
/obj/machinery/atmospherics/pipe/smart/manifold4w/scrubbers/hidden/layer2,
/obj/machinery/atmospherics/pipe/smart/manifold4w/supply/hidden/layer4,
/obj/machinery/atmospherics/pipe/smart/manifold4w/cyan/hidden,
/obj/effect/spawner/random/engineering/tracking_beacon,
/turf/open/floor/iron,
/area/station/cargo/exploration_office)
"Dc" = (
/obj/machinery/atmospherics/components/unary/vent_pump/on/layer4,
/obj/machinery/atmospherics/pipe/smart/manifold4w/cyan/hidden,
/turf/open/floor/iron,
/area/station/cargo/exploration_office)
"Dk" = (
/obj/structure/chair/office{
	dir = 1
	},
/obj/effect/landmark/start/explorer,
/obj/machinery/atmospherics/pipe/layer_manifold/cyan/hidden{
	dir = 8
	},
/turf/open/floor/iron,
/area/station/cargo/exploration_office)
"DY" = (
/obj/structure/lattice/catwalk,
/obj/structure/marker_beacon/indigo{
	pixel_x = 14;
	pixel_y = 15
	},
/obj/structure/railing{
	dir = 8
	},
/turf/open/space/basic,
/area/space/nearstation)
"Eb" = (
/obj/effect/turf_decal/stripes/line{
	dir = 4
	},
/obj/machinery/atmospherics/pipe/smart/manifold4w/cyan/hidden/layer4,
/turf/open/floor/engine,
/area/station/cargo/exploration_office)
"Gq" = (
/obj/docking_port/stationary{
	dir = 8;
	dwidth = 11;
	height = 24;
	name = "SS13: Auxiliary Dock, Station-Fore";
	shuttle_id = "whiteship_home";
	width = 35
	},
/turf/open/space/basic,
/area/template_noop)
"Jm" = (
/obj/machinery/dive_anchor/stationary,
/obj/effect/turf_decal/stripes/box,
/turf/open/floor/engine,
/area/station/cargo/exploration_office)
"JP" = (
/obj/structure/cable,
/turf/closed/wall,
/area/station/maintenance/port/fore)
"Oh" = (
/obj/structure/lattice,
/obj/structure/grille,
/turf/open/space/basic,
/area/space/nearstation)
"Qe" = (
/obj/effect/spawner/structure/window/reinforced,
/turf/open/floor/plating,
/area/station/cargo/exploration_office)
"Qt" = (
/obj/effect/turf_decal/stripes/line{
	dir = 5
	},
/turf/open/floor/engine,
/area/station/cargo/exploration_office)
"QZ" = (
/obj/machinery/light/directional/south,
/obj/structure/cable,
/obj/machinery/atmospherics/pipe/smart/manifold4w/scrubbers/hidden/layer2,
/obj/structure/rack,
/obj/item/multitool{
	pixel_x = -7;
	pixel_y = 2
	},
/obj/item/stack/impure_telecrystal{
	pixel_x = -6;
	pixel_y = -2
	},
/obj/item/stack/rods{
	pixel_x = 4;
	amount = 20
	},
/turf/open/floor/iron,
/area/station/cargo/exploration_office)
"SE" = (
/obj/effect/turf_decal/stripes/line{
	dir = 9
	},
/turf/open/floor/engine,
/area/station/cargo/exploration_office)
"TL" = (
/obj/structure/extinguisher_cabinet/directional/south,
/obj/structure/cable,
/obj/machinery/atmospherics/pipe/smart/manifold4w/scrubbers/hidden/layer2,
/obj/machinery/atmospherics/pipe/smart/manifold4w/cyan/hidden/layer4,
/obj/effect/landmark/start/explorer,
/obj/item/kirbyplants/random{
	pixel_x = 10
	},
/turf/open/floor/iron,
/area/station/cargo/exploration_office)
"Vn" = (
/obj/structure/cable,
/obj/machinery/door/airlock/mining{
	name = "Exploration Office"
	},
/obj/effect/mapping_helpers/airlock/access/all/command/gateway,
/obj/machinery/atmospherics/pipe/smart/manifold4w/cyan/hidden,
/obj/machinery/atmospherics/pipe/smart/manifold4w/scrubbers/hidden/layer2,
/obj/machinery/atmospherics/pipe/smart/manifold4w/supply/hidden/layer4,
/obj/machinery/door/firedoor,
/obj/effect/landmark/navigate_destination/exploration_office,
/turf/open/floor/iron,
/area/station/cargo/exploration_office)
"VV" = (
/obj/effect/turf_decal/tile/neutral/half/contrasted{
	dir = 1
	},
/obj/machinery/atmospherics/pipe/smart/manifold4w/cyan/hidden,
/obj/machinery/meter,
/obj/structure/cable,
/turf/open/floor/iron,
/area/station/maintenance/port/fore)
"WH" = (
/obj/machinery/power/apc/auto_name/directional/south,
/obj/structure/cable,
/obj/machinery/atmospherics/pipe/smart/manifold4w/scrubbers/hidden/layer2,
/obj/machinery/atmospherics/pipe/smart/manifold4w/cyan/hidden/layer4,
/turf/open/floor/iron,
/area/station/cargo/exploration_office)
"Xg" = (
/obj/effect/turf_decal/stripes/line,
/obj/effect/decal/cleanable/blood/oil,
/turf/open/floor/engine,
/area/station/cargo/exploration_office)
"YJ" = (
/obj/structure/lattice/catwalk,
/turf/open/space/basic,
/area/space/nearstation)
"YK" = (
/obj/structure/sign/warning/doors/directional/east,
/obj/structure/lattice/catwalk,
/obj/structure/railing{
	dir = 8
	},
/turf/open/space/basic,
/area/space/nearstation)
"YS" = (
/obj/structure/lattice/catwalk,
/obj/structure/sign/warning/directional/east,
/obj/structure/railing{
	dir = 8
	},
/turf/open/space/basic,
/area/space/nearstation)

(1,1,1) = {"
tk
tk
tk
tk
tk
tk
tk
tk
tk
tk
tk
tk
tk
tk
tk
tk
tk
tk
tk
tk
tk
"}
(2,1,1) = {"
tk
tk
tk
tk
tk
tk
tk
tk
tk
tk
tk
tk
tk
tk
ve
ve
ve
ve
ve
tk
tk
"}
(3,1,1) = {"
tk
tk
tk
tk
tk
tk
tk
tk
tk
tk
tk
tk
tk
iQ
wc
DY
YS
pS
YK
ve
tk
"}
(4,1,1) = {"
tk
tk
tk
tk
tk
tk
tk
tk
tk
tk
tk
tk
tk
BE
td
YJ
tt
pO
tt
ve
tk
"}
(5,1,1) = {"
tk
tk
tk
tk
tk
tk
tk
tk
tk
tk
tk
tk
tk
fd
YJ
jY
Qe
xw
tt
Oh
tk
"}
(6,1,1) = {"
tk
tk
tk
tk
tk
tk
tk
tk
tk
tk
tk
tk
tk
Qe
Qe
Qe
tt
sT
tt
ve
tk
"}
(7,1,1) = {"
tk
tk
tk
tk
tk
tk
tk
tk
tk
tk
tk
tk
tk
Qe
SE
wn
kj
vv
tt
ve
tk
"}
(8,1,1) = {"
tk
tk
tk
tk
tk
tk
tk
tk
tk
tk
tk
tk
tk
Qe
cf
Jm
Xg
WH
tt
ve
tk
"}
(9,1,1) = {"
tk
tk
tk
tk
tk
tk
tk
tk
tk
tk
tk
tk
tk
Qe
Qt
Eb
fm
TL
tt
ve
tk
"}
(10,1,1) = {"
tk
tk
tk
tk
tk
tk
tk
tk
tk
tk
tk
tk
tk
Qe
BQ
Dk
pb
QZ
tt
ve
tk
"}
(11,1,1) = {"
Gq
tk
tk
tk
tk
tk
tk
cg
tk
tk
tk
tk
tk
tt
ly
Dc
CS
mO
tt
ve
tk
"}
(12,1,1) = {"
tk
tk
tk
tk
tk
tk
tk
tk
tk
tk
tk
tk
tk
tt
tt
go
ww
hL
tt
tk
tk
"}
(13,1,1) = {"
tk
tk
tk
tk
tk
tk
tk
tk
tk
tk
tk
tk
tk
tk
tk
AK
Vn
AK
tk
tk
tk
"}
(14,1,1) = {"
tk
tk
tk
tk
tk
tk
tk
tk
tk
tk
tk
tk
tk
tk
tk
tk
pp
xz
dC
VV
tk
"}
(15,1,1) = {"
tk
tk
tk
tk
tk
tk
tk
tk
tk
tk
tk
tk
tk
tk
tk
tk
iH
tk
tk
sw
tk
"}
(16,1,1) = {"
tk
tk
tk
tk
tk
tk
tk
tk
tk
tk
tk
tk
tk
tk
tk
tk
tk
tk
tk
JP
tk
"}
