//MAP CONVERTED BY dmm2tgm.py THIS HEADER COMMENT PREVENTS RECONVERSION, DO NOT REMOVE
"a" = (
/obj/machinery/computer/communications{
	dir = 4
	},
/obj/machinery/status_display/ai/directional/west,
/obj/structure/phone_base/captain{
	pixel_x = 0;
	pixel_y = -27;
	dir = 1
	},
/turf/open/floor/carpet,
/area/station/command/heads_quarters/captain)

(1,1,1) = {"
a
"}
