//MAP CONVERTED BY dmm2tgm.py THIS HEADER COMMENT PREVENTS RECONVERSION, DO NOT REMOVE
"ai" = (
/obj/structure/lattice,
/turf/open/space/basic,
/area/space/nearstation)
"aI" = (
/obj/effect/turf_decal/stripes/line,
/obj/effect/turf_decal/stripes/line{
	dir = 1
	},
/obj/machinery/door/airlock/external{
	name = "Exploration Office Airlock"
	},
/obj/effect/mapping_helpers/airlock/access/all/command/gateway,
/obj/effect/mapping_helpers/airlock/cyclelink_helper{
	dir = 4
	},
/turf/open/floor/iron,
/area/station/cargo/exploration_office)
"aJ" = (
/obj/effect/turf_decal/stripes/line,
/obj/effect/turf_decal/stripes/line{
	dir = 1
	},
/obj/machinery/light/small/directional/south,
/obj/machinery/atmospherics/components/unary/airlock_pump{
	dir = 4
	},
/turf/open/floor/iron,
/area/station/cargo/exploration_office)
"aM" = (
/obj/structure/sign/warning/doors/directional/east,
/obj/structure/lattice/catwalk,
/obj/structure/railing{
	dir = 8
	},
/turf/open/space/basic,
/area/space/nearstation)
"cJ" = (
/obj/effect/turf_decal/stripes/line{
	dir = 9
	},
/turf/open/floor/engine,
/area/station/cargo/exploration_office)
"cY" = (
/obj/effect/spawner/structure/window/reinforced,
/turf/open/floor/plating,
/area/station/cargo/exploration_office)
"dp" = (
/obj/structure/cable,
/obj/machinery/atmospherics/pipe/smart/manifold4w/scrubbers/hidden/layer2,
/turf/open/floor/iron,
/area/station/cargo/exploration_office)
"eF" = (
/obj/effect/landmark/start/explorer,
/obj/effect/turf_decal/stripes/line{
	dir = 1
	},
/turf/open/floor/engine,
/area/station/cargo/exploration_office)
"gn" = (
/obj/effect/turf_decal/tile/neutral/anticorner/contrasted{
	dir = 4
	},
/obj/structure/closet/firecloset,
/obj/effect/turf_decal/bot,
/obj/structure/cable,
/turf/open/floor/iron,
/area/station/maintenance/port/fore)
"hi" = (
/obj/structure/extinguisher_cabinet/directional/south,
/obj/structure/cable,
/obj/machinery/atmospherics/pipe/smart/manifold4w/scrubbers/hidden/layer2,
/obj/machinery/atmospherics/pipe/smart/manifold4w/cyan/hidden/layer4,
/obj/effect/landmark/start/explorer,
/obj/item/kirbyplants/random{
	pixel_x = 10
	},
/turf/open/floor/iron,
/area/station/cargo/exploration_office)
"ii" = (
/obj/structure/lattice/catwalk,
/obj/structure/railing{
	dir = 8
	},
/turf/open/space/basic,
/area/space/nearstation)
"jz" = (
/obj/structure/cable,
/obj/machinery/atmospherics/pipe/smart/manifold4w/scrubbers/hidden/layer2,
/obj/machinery/atmospherics/pipe/smart/manifold4w/supply/hidden/layer4,
/obj/machinery/atmospherics/pipe/smart/manifold4w/cyan/hidden,
/obj/effect/spawner/random/engineering/tracking_beacon,
/turf/open/floor/iron,
/area/station/cargo/exploration_office)
"oq" = (
/obj/structure/lattice/catwalk,
/turf/open/space/basic,
/area/space/nearstation)
"pw" = (
/obj/machinery/light/directional/south,
/obj/structure/cable,
/obj/machinery/atmospherics/pipe/smart/manifold4w/scrubbers/hidden/layer2,
/obj/structure/rack,
/obj/item/multitool{
	pixel_x = -7;
	pixel_y = 2
	},
/obj/item/stack/impure_telecrystal{
	pixel_x = -6;
	pixel_y = -2
	},
/obj/item/stack/rods{
	pixel_x = 4;
	amount = 20
	},
/turf/open/floor/iron,
/area/station/cargo/exploration_office)
"sg" = (
/obj/effect/turf_decal/stripes/line{
	dir = 8
	},
/turf/open/floor/engine,
/area/station/cargo/exploration_office)
"uf" = (
/obj/effect/turf_decal/stripes/line,
/obj/effect/decal/cleanable/blood/oil,
/turf/open/floor/engine,
/area/station/cargo/exploration_office)
"wl" = (
/obj/machinery/suit_storage_unit/explorer,
/obj/machinery/light_switch/directional/east,
/obj/effect/turf_decal/bot,
/obj/effect/decal/cleanable/cobweb/cobweb2,
/turf/open/floor/iron,
/area/station/cargo/exploration_office)
"wV" = (
/obj/effect/turf_decal/stripes/line,
/obj/effect/turf_decal/stripes/line{
	dir = 1
	},
/obj/machinery/door/airlock/external{
	name = "Exploration Office Airlock"
	},
/obj/machinery/atmospherics/pipe/smart/manifold4w/scrubbers/hidden/layer2,
/obj/machinery/atmospherics/pipe/smart/manifold4w/cyan/hidden/layer4,
/obj/effect/mapping_helpers/airlock/access/all/command/gateway,
/obj/effect/mapping_helpers/airlock/cyclelink_helper{
	dir = 8
	},
/turf/open/floor/iron,
/area/station/cargo/exploration_office)
"xB" = (
/turf/closed/wall,
/area/station/hallway/secondary/entry)
"yC" = (
/turf/open/space/basic,
/area/template_noop)
"zx" = (
/obj/machinery/computer/anchor_controller,
/turf/open/floor/iron,
/area/station/cargo/exploration_office)
"Ah" = (
/obj/structure/lattice/catwalk,
/obj/structure/marker_beacon/indigo{
	pixel_x = -12;
	pixel_y = -12
	},
/obj/structure/railing{
	dir = 1
	},
/turf/open/space/basic,
/area/space/nearstation)
"Co" = (
/obj/effect/turf_decal/tile/neutral/half/contrasted{
	dir = 1
	},
/obj/machinery/atmospherics/pipe/smart/manifold4w/cyan/hidden,
/obj/machinery/meter,
/obj/structure/cable,
/turf/open/floor/iron,
/area/station/maintenance/port/fore)
"CK" = (
/obj/structure/lattice,
/obj/structure/grille,
/turf/open/space/basic,
/area/space/nearstation)
"CS" = (
/obj/structure/lattice/catwalk,
/obj/structure/marker_beacon/indigo{
	pixel_x = -12;
	pixel_y = 15
	},
/turf/open/space/basic,
/area/space/nearstation)
"Dq" = (
/obj/effect/turf_decal/stripes/line{
	dir = 5
	},
/turf/open/floor/engine,
/area/station/cargo/exploration_office)
"EY" = (
/obj/machinery/airalarm/directional/south,
/obj/structure/table/reinforced,
/obj/machinery/recharger{
	pixel_x = -9;
	pixel_y = 7
	},
/obj/machinery/cell_charger{
	pixel_x = 3
	},
/turf/open/floor/iron,
/area/station/cargo/exploration_office)
"GG" = (
/obj/machinery/dive_anchor,
/turf/open/space/basic,
/area/space/nearstation)
"Hl" = (
/obj/machinery/suit_storage_unit/explorer,
/obj/machinery/firealarm/directional/east,
/obj/effect/turf_decal/bot,
/turf/open/floor/iron,
/area/station/cargo/exploration_office)
"HL" = (
/obj/structure/tank_dispenser/oxygen{
	pixel_y = 2;
	pixel_x = 2
	},
/obj/machinery/camera/autoname/directional/north,
/turf/open/floor/iron,
/area/station/cargo/exploration_office)
"HW" = (
/obj/effect/turf_decal/stripes/line{
	dir = 6
	},
/obj/machinery/atmospherics/pipe/smart/manifold4w/cyan/hidden/layer4,
/turf/open/floor/engine,
/area/station/cargo/exploration_office)
"IV" = (
/obj/structure/lattice/catwalk,
/obj/structure/railing/corner/end/flip{
	dir = 4
	},
/turf/open/space/basic,
/area/space/nearstation)
"Mf" = (
/obj/effect/decal/cleanable/dirt,
/obj/machinery/atmospherics/pipe/smart/manifold4w/cyan/hidden,
/obj/machinery/atmospherics/pipe/smart/manifold4w/supply/hidden/layer4,
/obj/machinery/atmospherics/pipe/smart/manifold4w/scrubbers/hidden/layer2,
/turf/open/floor/iron,
/area/station/hallway/secondary/entry)
"Mk" = (
/obj/structure/lattice/catwalk,
/obj/structure/marker_beacon/indigo{
	pixel_x = 14;
	pixel_y = -12
	},
/turf/open/space/basic,
/area/space/nearstation)
"Mz" = (
/obj/structure/lattice/catwalk,
/obj/structure/sign/warning/directional/east,
/obj/structure/railing{
	dir = 8
	},
/turf/open/space/basic,
/area/space/nearstation)
"Pm" = (
/obj/structure/sign/warning/vacuum/external/directional/south,
/obj/machinery/atmospherics/pipe/smart/manifold4w/scrubbers/hidden/layer2,
/obj/machinery/atmospherics/pipe/smart/manifold4w/cyan/hidden/layer4,
/turf/open/floor/iron,
/area/station/cargo/exploration_office)
"PJ" = (
/obj/machinery/door/airlock{
	name = "Auxiliary Storage Closet"
	},
/obj/effect/turf_decal/stripes/line,
/obj/effect/turf_decal/stripes/line{
	dir = 1
	},
/obj/machinery/atmospherics/pipe/smart/manifold4w/cyan/hidden,
/obj/structure/cable,
/turf/open/floor/iron,
/area/station/maintenance/port/fore)
"PK" = (
/obj/structure/cable,
/obj/machinery/atmospherics/pipe/smart/manifold4w/scrubbers/hidden/layer2,
/obj/machinery/atmospherics/pipe/smart/manifold4w/supply/hidden/layer4,
/obj/machinery/atmospherics/pipe/smart/manifold4w/cyan/hidden,
/turf/open/floor/iron,
/area/station/cargo/exploration_office)
"PQ" = (
/obj/effect/turf_decal/tile/neutral{
	dir = 1
	},
/obj/machinery/atmospherics/pipe/smart/manifold4w/cyan/hidden,
/obj/structure/cable,
/obj/machinery/atmospherics/pipe/smart/manifold4w/supply/hidden/layer4,
/obj/machinery/atmospherics/pipe/smart/manifold4w/scrubbers/hidden/layer2,
/turf/open/floor/iron,
/area/station/hallway/secondary/entry)
"Rf" = (
/obj/structure/cable,
/turf/closed/wall,
/area/station/maintenance/port/fore)
"RG" = (
/obj/structure/chair/office{
	dir = 1
	},
/obj/effect/landmark/start/explorer,
/obj/machinery/atmospherics/pipe/layer_manifold/cyan/hidden{
	dir = 8
	},
/turf/open/floor/iron,
/area/station/cargo/exploration_office)
"SH" = (
/obj/effect/turf_decal/tile/neutral/opposingcorners,
/obj/machinery/atmospherics/pipe/smart/manifold4w/cyan/hidden,
/obj/structure/cable,
/turf/open/floor/iron,
/area/station/hallway/secondary/entry)
"Ve" = (
/obj/structure/cable,
/obj/machinery/door/airlock/mining{
	name = "Exploration Office"
	},
/obj/effect/mapping_helpers/airlock/access/all/command/gateway,
/obj/machinery/atmospherics/pipe/smart/manifold4w/cyan/hidden,
/obj/machinery/atmospherics/pipe/smart/manifold4w/scrubbers/hidden/layer2,
/obj/machinery/atmospherics/pipe/smart/manifold4w/supply/hidden/layer4,
/obj/machinery/door/firedoor,
/obj/effect/landmark/navigate_destination/exploration_office,
/turf/open/floor/iron,
/area/station/cargo/exploration_office)
"Vi" = (
/obj/machinery/dive_anchor/stationary,
/obj/effect/turf_decal/stripes/box,
/turf/open/floor/engine,
/area/station/cargo/exploration_office)
"VR" = (
/obj/structure/lattice/catwalk,
/obj/structure/marker_beacon/indigo{
	pixel_x = 14;
	pixel_y = 15
	},
/obj/structure/railing{
	dir = 8
	},
/turf/open/space/basic,
/area/space/nearstation)
"Wo" = (
/obj/structure/lattice/catwalk,
/obj/structure/railing/corner/end,
/turf/open/space/basic,
/area/space/nearstation)
"WZ" = (
/obj/docking_port/stationary{
	dir = 8;
	dwidth = 11;
	height = 24;
	name = "SS13: Auxiliary Dock, Station-Fore";
	shuttle_id = "whiteship_home";
	width = 35
	},
/turf/open/space/basic,
/area/template_noop)
"Xo" = (
/turf/closed/wall,
/area/station/cargo/exploration_office)
"YB" = (
/obj/machinery/light/directional/west,
/obj/machinery/atmospherics/components/unary/vent_scrubber/on/layer2,
/obj/effect/turf_decal/stripes/line{
	dir = 10
	},
/turf/open/floor/engine,
/area/station/cargo/exploration_office)
"YH" = (
/obj/effect/turf_decal/stripes/line{
	dir = 4
	},
/obj/machinery/atmospherics/pipe/smart/manifold4w/cyan/hidden/layer4,
/turf/open/floor/engine,
/area/station/cargo/exploration_office)
"YP" = (
/obj/machinery/power/apc/auto_name/directional/south,
/obj/structure/cable,
/obj/machinery/atmospherics/pipe/smart/manifold4w/scrubbers/hidden/layer2,
/obj/machinery/atmospherics/pipe/smart/manifold4w/cyan/hidden/layer4,
/turf/open/floor/iron,
/area/station/cargo/exploration_office)
"ZG" = (
/turf/template_noop,
/area/template_noop)
"ZW" = (
/obj/machinery/atmospherics/components/unary/vent_pump/on/layer4,
/obj/machinery/atmospherics/pipe/smart/manifold4w/cyan/hidden,
/turf/open/floor/iron,
/area/station/cargo/exploration_office)

(1,1,1) = {"
ZG
ZG
ZG
ZG
ZG
ZG
ZG
ZG
ZG
ZG
ZG
ZG
ZG
ZG
ZG
ZG
ZG
ZG
ZG
ZG
ZG
"}
(2,1,1) = {"
ZG
ZG
ZG
ZG
ZG
ZG
ZG
ZG
ZG
ZG
ZG
ZG
ZG
ZG
ai
ai
ai
ai
ai
ZG
ZG
"}
(3,1,1) = {"
ZG
ZG
ZG
ZG
ZG
ZG
ZG
ZG
ZG
ZG
ZG
ZG
ZG
Mk
Wo
VR
Mz
ii
aM
ai
ZG
"}
(4,1,1) = {"
ZG
ZG
ZG
ZG
ZG
ZG
ZG
ZG
ZG
ZG
ZG
ZG
ZG
IV
GG
oq
Xo
aI
Xo
ai
ZG
"}
(5,1,1) = {"
ZG
ZG
ZG
ZG
ZG
ZG
ZG
ZG
ZG
ZG
ZG
ZG
ZG
Ah
oq
CS
cY
aJ
Xo
CK
ZG
"}
(6,1,1) = {"
ZG
ZG
ZG
ZG
ZG
ZG
ZG
ZG
ZG
ZG
ZG
ZG
ZG
cY
cY
cY
Xo
wV
Xo
ai
ZG
"}
(7,1,1) = {"
ZG
ZG
ZG
ZG
ZG
ZG
ZG
ZG
ZG
ZG
ZG
ZG
ZG
cY
cJ
sg
YB
Pm
Xo
ai
ZG
"}
(8,1,1) = {"
ZG
ZG
ZG
ZG
ZG
ZG
ZG
ZG
ZG
ZG
ZG
ZG
ZG
cY
eF
Vi
uf
YP
Xo
ai
ZG
"}
(9,1,1) = {"
ZG
ZG
ZG
ZG
ZG
ZG
ZG
ZG
ZG
ZG
ZG
ZG
ZG
cY
Dq
YH
HW
hi
Xo
ai
ZG
"}
(10,1,1) = {"
ZG
ZG
ZG
ZG
ZG
ZG
ZG
ZG
ZG
ZG
ZG
ZG
ZG
cY
zx
RG
dp
pw
Xo
ai
ZG
"}
(11,1,1) = {"
WZ
ZG
ZG
ZG
ZG
ZG
ZG
yC
ZG
ZG
ZG
ZG
ZG
Xo
HL
ZW
jz
EY
Xo
ai
ZG
"}
(12,1,1) = {"
ZG
ZG
ZG
ZG
ZG
ZG
ZG
ZG
ZG
ZG
ZG
ZG
ZG
Xo
Xo
wl
PK
Hl
Xo
ZG
ZG
"}
(13,1,1) = {"
ZG
ZG
ZG
ZG
ZG
ZG
ZG
ZG
ZG
ZG
ZG
ZG
ZG
ZG
ZG
xB
Ve
xB
ZG
ZG
ZG
"}
(14,1,1) = {"
ZG
ZG
ZG
ZG
ZG
ZG
ZG
ZG
ZG
ZG
ZG
ZG
ZG
ZG
ZG
ZG
PQ
SH
PJ
Co
ZG
"}
(15,1,1) = {"
ZG
ZG
ZG
ZG
ZG
ZG
ZG
ZG
ZG
ZG
ZG
ZG
ZG
ZG
ZG
ZG
Mf
ZG
ZG
gn
ZG
"}
(16,1,1) = {"
ZG
ZG
ZG
ZG
ZG
ZG
ZG
ZG
ZG
ZG
ZG
ZG
ZG
ZG
ZG
ZG
ZG
ZG
ZG
Rf
ZG
"}
