//MAP CONVERTED BY dmm2tgm.py THIS HEADER COMMENT PREVENTS RECONVERSION, DO NOT REMOVE
"a" = (
/obj/machinery/dive_anchor,
/turf/open/space/basic,
/area/space/nearstation)
"c" = (
/obj/structure/rack,
/obj/machinery/airalarm/directional/south,
/turf/open/floor/engine,
/area/station/cargo/exploration_office)
"d" = (
/obj/structure/cable,
/turf/closed/wall,
/area/station/maintenance/port/fore)
"g" = (
/obj/effect/turf_decal/tile/neutral/half/contrasted{
	dir = 1
	},
/obj/machinery/atmospherics/pipe/smart/manifold4w/cyan/hidden,
/obj/machinery/meter,
/obj/structure/cable,
/turf/open/floor/iron,
/area/station/maintenance/port/fore)
"h" = (
/obj/machinery/suit_storage_unit/standard_unit,
/turf/open/floor/engine,
/area/station/cargo/exploration_office)
"i" = (
/obj/machinery/light/directional/south,
/obj/structure/cable,
/obj/machinery/atmospherics/pipe/smart/manifold4w/scrubbers/hidden/layer2,
/turf/open/floor/engine,
/area/station/cargo/exploration_office)
"j" = (
/obj/machinery/suit_storage_unit/standard_unit,
/obj/machinery/light_switch/directional/east,
/turf/open/floor/engine,
/area/station/cargo/exploration_office)
"k" = (
/obj/effect/turf_decal/stripes/line,
/obj/effect/turf_decal/stripes/line{
	dir = 1
	},
/obj/machinery/light/small/directional/south,
/obj/machinery/atmospherics/components/unary/airlock_pump{
	dir = 4
	},
/turf/open/floor/iron,
/area/station/cargo/exploration_office)
"l" = (
/obj/effect/turf_decal/stripes/line,
/obj/effect/turf_decal/stripes/line{
	dir = 1
	},
/obj/machinery/door/airlock/external{
	name = "Exploration Office Airlock"
	},
/obj/machinery/atmospherics/pipe/smart/manifold4w/scrubbers/hidden/layer2,
/obj/machinery/atmospherics/pipe/smart/manifold4w/cyan/hidden/layer4,
/turf/open/floor/iron,
/area/station/cargo/exploration_office)
"n" = (
/obj/effect/turf_decal/stripes/line,
/obj/effect/turf_decal/stripes/line{
	dir = 1
	},
/obj/machinery/door/airlock/external{
	name = "Exploration Office Airlock"
	},
/turf/open/floor/iron,
/area/station/cargo/exploration_office)
"o" = (
/turf/template_noop,
/area/template_noop)
"p" = (
/obj/effect/turf_decal/tile/neutral{
	dir = 1
	},
/obj/machinery/atmospherics/pipe/smart/manifold4w/cyan/hidden,
/obj/structure/cable,
/obj/machinery/atmospherics/pipe/smart/manifold4w/supply/hidden/layer4,
/obj/machinery/atmospherics/pipe/smart/manifold4w/scrubbers/hidden/layer2,
/turf/open/floor/iron,
/area/station/hallway/secondary/entry)
"q" = (
/obj/machinery/door/airlock{
	name = "Auxiliary Storage Closet"
	},
/obj/effect/turf_decal/stripes/line,
/obj/effect/turf_decal/stripes/line{
	dir = 1
	},
/obj/machinery/atmospherics/pipe/smart/manifold4w/cyan/hidden,
/obj/structure/cable,
/turf/open/floor/iron,
/area/station/maintenance/port/fore)
"r" = (
/obj/machinery/power/apc/auto_name/directional/south,
/obj/structure/cable,
/obj/machinery/atmospherics/pipe/smart/manifold4w/scrubbers/hidden/layer2,
/obj/machinery/atmospherics/pipe/smart/manifold4w/cyan/hidden/layer4,
/turf/open/floor/engine,
/area/station/cargo/exploration_office)
"s" = (
/obj/structure/cable,
/obj/machinery/atmospherics/pipe/smart/manifold4w/scrubbers/hidden/layer2,
/obj/machinery/atmospherics/pipe/smart/manifold4w/supply/hidden/layer4,
/obj/machinery/atmospherics/pipe/smart/manifold4w/cyan/hidden,
/turf/open/floor/engine,
/area/station/cargo/exploration_office)
"t" = (
/obj/effect/decal/cleanable/dirt,
/obj/machinery/atmospherics/pipe/smart/manifold4w/cyan/hidden,
/obj/machinery/atmospherics/pipe/smart/manifold4w/supply/hidden/layer4,
/obj/machinery/atmospherics/pipe/smart/manifold4w/supply/hidden/layer4,
/obj/machinery/atmospherics/pipe/smart/manifold4w/scrubbers/hidden/layer2,
/turf/open/floor/iron,
/area/station/hallway/secondary/entry)
"u" = (
/obj/effect/turf_decal/stripes/line{
	dir = 4
	},
/turf/open/floor/engine,
/area/station/cargo/exploration_office)
"v" = (
/obj/structure/cable,
/obj/machinery/atmospherics/pipe/smart/manifold4w/supply/hidden/layer4,
/obj/machinery/atmospherics/pipe/smart/manifold4w/scrubbers/hidden/layer2,
/obj/machinery/door/airlock/mining{
	name = "Exploration Office"
	},
/obj/effect/mapping_helpers/airlock/access/all/command/gateway,
/obj/machinery/atmospherics/pipe/smart/manifold4w/cyan/hidden,
/obj/machinery/atmospherics/pipe/smart/manifold4w/scrubbers/hidden/layer2,
/obj/machinery/atmospherics/pipe/smart/manifold4w/supply/hidden/layer4,
/turf/open/floor/iron,
/area/station/hallway/secondary/entry)
"w" = (
/turf/open/floor/engine,
/area/station/cargo/exploration_office)
"x" = (
/obj/effect/turf_decal/stripes/line{
	dir = 6
	},
/obj/machinery/atmospherics/pipe/smart/manifold4w/cyan/hidden/layer4,
/turf/open/floor/engine,
/area/station/cargo/exploration_office)
"z" = (
/obj/structure/tank_dispenser/oxygen{
	pixel_y = 2;
	pixel_x = 2
	},
/turf/open/floor/engine,
/area/station/cargo/exploration_office)
"A" = (
/turf/open/floor/catwalk_floor,
/area/space/nearstation)
"B" = (
/obj/structure/chair/office{
	dir = 1
	},
/turf/open/floor/engine,
/area/station/cargo/exploration_office)
"C" = (
/obj/structure/extinguisher_cabinet/directional/south,
/obj/structure/cable,
/obj/machinery/atmospherics/pipe/smart/manifold4w/scrubbers/hidden/layer2,
/obj/machinery/atmospherics/pipe/smart/manifold4w/cyan/hidden/layer4,
/turf/open/floor/engine,
/area/station/cargo/exploration_office)
"D" = (
/turf/closed/wall,
/area/station/hallway/secondary/entry)
"E" = (
/obj/machinery/computer/anchor_controller,
/turf/open/floor/engine,
/area/station/cargo/exploration_office)
"F" = (
/obj/machinery/light/directional/west,
/obj/effect/turf_decal/stripes/line,
/obj/machinery/atmospherics/components/unary/vent_scrubber/on/layer2,
/turf/open/floor/engine,
/area/station/cargo/exploration_office)
"G" = (
/obj/structure/lattice,
/turf/closed/wall,
/area/station/cargo/exploration_office)
"H" = (
/obj/structure/sign/warning/directional/south,
/turf/open/floor/catwalk_floor,
/area/space/nearstation)
"I" = (
/turf/closed/wall,
/area/station/cargo/exploration_office)
"K" = (
/obj/structure/cable,
/obj/machinery/atmospherics/pipe/smart/manifold4w/scrubbers/hidden/layer2,
/obj/machinery/atmospherics/pipe/layer_manifold/cyan/hidden{
	dir = 8
	},
/turf/open/floor/engine,
/area/station/cargo/exploration_office)
"N" = (
/obj/effect/turf_decal/tile/neutral/anticorner/contrasted{
	dir = 4
	},
/obj/structure/closet/firecloset,
/obj/effect/turf_decal/bot,
/obj/structure/cable,
/turf/open/floor/iron,
/area/station/maintenance/port/fore)
"O" = (
/obj/docking_port/stationary{
	dir = 8;
	dwidth = 11;
	height = 24;
	name = "SS13: Auxiliary Dock, Station-Fore";
	shuttle_id = "whiteship_home";
	width = 35
	},
/turf/open/space/basic,
/area/template_noop)
"P" = (
/obj/effect/turf_decal/stripes/line,
/turf/open/floor/engine,
/area/station/cargo/exploration_office)
"Q" = (
/obj/machinery/dive_anchor/stationary,
/obj/effect/turf_decal/stripes/box,
/turf/open/floor/engine,
/area/station/cargo/exploration_office)
"R" = (
/obj/effect/spawner/structure/window/reinforced,
/turf/open/floor/plating,
/area/station/cargo/exploration_office)
"S" = (
/obj/structure/sign/warning/doors/directional/east,
/turf/open/floor/catwalk_floor,
/area/space/nearstation)
"T" = (
/obj/structure/sign/warning/vacuum/external/directional/south,
/obj/machinery/atmospherics/pipe/smart/manifold4w/scrubbers/hidden/layer2,
/obj/machinery/atmospherics/pipe/smart/manifold4w/cyan/hidden/layer4,
/turf/open/floor/engine,
/area/station/cargo/exploration_office)
"U" = (
/obj/effect/turf_decal/tile/neutral/opposingcorners,
/obj/machinery/atmospherics/pipe/smart/manifold4w/cyan/hidden,
/obj/structure/cable,
/turf/open/floor/iron,
/area/station/hallway/secondary/entry)
"V" = (
/turf/open/space/basic,
/area/template_noop)
"W" = (
/obj/machinery/atmospherics/components/unary/vent_pump/on/layer4,
/turf/open/floor/engine,
/area/station/cargo/exploration_office)
"Z" = (
/obj/structure/lattice,
/turf/open/space/basic,
/area/space/nearstation)

(1,1,1) = {"
o
o
o
o
o
o
o
o
o
o
o
o
o
o
o
o
o
o
o
o
o
"}
(2,1,1) = {"
o
o
o
o
o
o
o
o
o
o
o
o
o
o
o
o
o
o
o
o
o
"}
(3,1,1) = {"
o
o
o
o
o
o
o
o
o
o
o
o
o
A
A
A
A
A
S
Z
o
"}
(4,1,1) = {"
o
o
o
o
o
o
o
o
o
o
o
o
o
A
a
H
I
n
I
Z
o
"}
(5,1,1) = {"
o
o
o
o
o
o
o
o
o
o
o
o
o
A
A
A
I
k
I
Z
o
"}
(6,1,1) = {"
o
o
o
o
o
o
o
o
o
o
o
o
o
R
R
R
I
l
I
Z
o
"}
(7,1,1) = {"
o
o
o
o
o
o
o
o
o
o
o
o
o
R
w
w
F
T
I
Z
o
"}
(8,1,1) = {"
o
o
o
o
o
o
o
o
o
o
o
o
o
R
w
Q
P
r
I
Z
o
"}
(9,1,1) = {"
o
o
o
o
o
o
o
o
o
o
o
o
o
R
u
u
x
C
I
Z
o
"}
(10,1,1) = {"
o
o
o
o
o
o
o
o
o
o
o
o
o
R
E
B
K
i
I
Z
o
"}
(11,1,1) = {"
O
o
o
o
o
o
o
V
o
o
o
o
o
I
z
W
s
c
I
Z
o
"}
(12,1,1) = {"
o
o
o
o
o
o
o
o
o
o
o
o
o
I
I
j
s
h
G
o
o
"}
(13,1,1) = {"
o
o
o
o
o
o
o
o
o
o
o
o
o
o
o
D
v
D
o
o
o
"}
(14,1,1) = {"
o
o
o
o
o
o
o
o
o
o
o
o
o
o
o
o
p
U
q
g
o
"}
(15,1,1) = {"
o
o
o
o
o
o
o
o
o
o
o
o
o
o
o
o
t
o
o
N
o
"}
(16,1,1) = {"
o
o
o
o
o
o
o
o
o
o
o
o
o
o
o
o
o
o
o
d
o
"}
