//MAP CONVERTED BY dmm2tgm.py THIS HEADER COMMENT PREVENTS RECONVERSION, DO NOT REMOVE
"ba" = (
/obj/machinery/power/apc/auto_name/directional/south,
/obj/structure/cable,
/obj/machinery/atmospherics/pipe/smart/manifold4w/scrubbers/hidden/layer2,
/obj/machinery/atmospherics/pipe/smart/manifold4w/cyan/hidden/layer4,
/turf/open/floor/iron,
/area/station/cargo/exploration_office)
"co" = (
/obj/effect/turf_decal/tile/neutral/anticorner/contrasted{
	dir = 4
	},
/obj/structure/closet/firecloset,
/obj/effect/turf_decal/bot,
/obj/structure/cable,
/turf/open/floor/iron,
/area/station/maintenance/port/fore)
"cs" = (
/obj/structure/cable,
/obj/machinery/door/airlock/mining{
	name = "Exploration Office"
	},
/obj/effect/mapping_helpers/airlock/access/all/command/gateway,
/obj/machinery/atmospherics/pipe/smart/manifold4w/cyan/hidden,
/obj/machinery/atmospherics/pipe/smart/manifold4w/scrubbers/hidden/layer2,
/obj/machinery/atmospherics/pipe/smart/manifold4w/supply/hidden/layer4,
/obj/machinery/door/firedoor,
/obj/effect/landmark/navigate_destination/exploration_office,
/turf/open/floor/iron,
/area/station/cargo/exploration_office)
"dp" = (
/obj/effect/decal/cleanable/dirt,
/obj/machinery/atmospherics/pipe/smart/manifold4w/cyan/hidden,
/obj/machinery/atmospherics/pipe/smart/manifold4w/supply/hidden/layer4,
/obj/machinery/atmospherics/pipe/smart/manifold4w/scrubbers/hidden/layer2,
/turf/open/floor/iron,
/area/station/hallway/secondary/entry)
"en" = (
/obj/effect/turf_decal/stripes/line,
/obj/effect/turf_decal/stripes/line{
	dir = 1
	},
/obj/machinery/light/small/directional/south,
/obj/machinery/atmospherics/components/unary/airlock_pump{
	dir = 4
	},
/turf/open/floor/iron,
/area/station/cargo/exploration_office)
"fo" = (
/obj/effect/turf_decal/stripes/line{
	dir = 9
	},
/turf/open/floor/engine,
/area/station/cargo/exploration_office)
"fY" = (
/obj/structure/cable,
/obj/machinery/atmospherics/pipe/smart/manifold4w/scrubbers/hidden/layer2,
/turf/open/floor/iron,
/area/station/cargo/exploration_office)
"gQ" = (
/obj/machinery/suit_storage_unit/explorer,
/obj/machinery/firealarm/directional/east,
/obj/effect/turf_decal/bot,
/turf/open/floor/iron,
/area/station/cargo/exploration_office)
"hc" = (
/turf/open/space/basic,
/area/template_noop)
"jG" = (
/obj/structure/lattice/catwalk,
/obj/structure/railing/corner/end/flip{
	dir = 4
	},
/turf/open/space/basic,
/area/space/nearstation)
"kS" = (
/obj/machinery/dive_anchor,
/turf/open/space/basic,
/area/space/nearstation)
"ll" = (
/obj/machinery/suit_storage_unit/explorer,
/obj/machinery/light_switch/directional/east,
/obj/effect/turf_decal/bot,
/obj/effect/decal/cleanable/cobweb/cobweb2,
/turf/open/floor/iron,
/area/station/cargo/exploration_office)
"lQ" = (
/obj/machinery/light/directional/south,
/obj/structure/cable,
/obj/machinery/atmospherics/pipe/smart/manifold4w/scrubbers/hidden/layer2,
/obj/structure/rack,
/obj/item/multitool{
	pixel_x = -7;
	pixel_y = 2
	},
/obj/item/stack/impure_telecrystal{
	pixel_x = -6;
	pixel_y = -2
	},
/obj/item/stack/rods{
	pixel_x = 4;
	amount = 20
	},
/turf/open/floor/iron,
/area/station/cargo/exploration_office)
"mx" = (
/obj/structure/lattice,
/obj/structure/grille,
/turf/open/space/basic,
/area/space/nearstation)
"oJ" = (
/obj/structure/lattice/catwalk,
/obj/structure/railing{
	dir = 8
	},
/turf/open/space/basic,
/area/space/nearstation)
"pW" = (
/obj/structure/lattice,
/turf/open/space/basic,
/area/space/nearstation)
"qQ" = (
/obj/structure/lattice/catwalk,
/obj/structure/railing/corner/end,
/turf/open/space/basic,
/area/space/nearstation)
"sf" = (
/obj/machinery/door/airlock{
	name = "Auxiliary Storage Closet"
	},
/obj/effect/turf_decal/stripes/line,
/obj/effect/turf_decal/stripes/line{
	dir = 1
	},
/obj/machinery/atmospherics/pipe/smart/manifold4w/cyan/hidden,
/obj/structure/cable,
/turf/open/floor/iron,
/area/station/maintenance/port/fore)
"sD" = (
/turf/template_noop,
/area/template_noop)
"tT" = (
/obj/structure/cable,
/obj/machinery/atmospherics/pipe/smart/manifold4w/scrubbers/hidden/layer2,
/obj/machinery/atmospherics/pipe/smart/manifold4w/supply/hidden/layer4,
/obj/machinery/atmospherics/pipe/smart/manifold4w/cyan/hidden,
/turf/open/floor/iron,
/area/station/cargo/exploration_office)
"vF" = (
/obj/structure/lattice/catwalk,
/obj/structure/marker_beacon/indigo{
	pixel_x = 14;
	pixel_y = -12
	},
/turf/open/space/basic,
/area/space/nearstation)
"wK" = (
/obj/effect/turf_decal/tile/neutral{
	dir = 1
	},
/obj/machinery/atmospherics/pipe/smart/manifold4w/cyan/hidden,
/obj/structure/cable,
/obj/machinery/atmospherics/pipe/smart/manifold4w/supply/hidden/layer4,
/obj/machinery/atmospherics/pipe/smart/manifold4w/scrubbers/hidden/layer2,
/turf/open/floor/iron,
/area/station/hallway/secondary/entry)
"wP" = (
/obj/effect/turf_decal/stripes/line{
	dir = 6
	},
/obj/machinery/atmospherics/pipe/smart/manifold4w/cyan/hidden/layer4,
/turf/open/floor/engine,
/area/station/cargo/exploration_office)
"zt" = (
/obj/structure/tank_dispenser/oxygen{
	pixel_y = 2;
	pixel_x = 2
	},
/obj/machinery/camera/autoname/directional/north,
/turf/open/floor/iron,
/area/station/cargo/exploration_office)
"At" = (
/obj/structure/cable,
/turf/closed/wall,
/area/station/maintenance/port/fore)
"Ck" = (
/obj/structure/cable,
/obj/machinery/atmospherics/pipe/smart/manifold4w/scrubbers/hidden/layer2,
/obj/machinery/atmospherics/pipe/smart/manifold4w/supply/hidden/layer4,
/obj/machinery/atmospherics/pipe/smart/manifold4w/cyan/hidden,
/obj/effect/spawner/random/engineering/tracking_beacon,
/turf/open/floor/iron,
/area/station/cargo/exploration_office)
"De" = (
/obj/machinery/light/directional/west,
/obj/machinery/atmospherics/components/unary/vent_scrubber/on/layer2,
/obj/effect/turf_decal/stripes/line{
	dir = 10
	},
/turf/open/floor/engine,
/area/station/cargo/exploration_office)
"Er" = (
/turf/closed/wall,
/area/station/hallway/secondary/entry)
"Fw" = (
/obj/machinery/computer/anchor_controller,
/turf/open/floor/iron,
/area/station/cargo/exploration_office)
"Ge" = (
/obj/effect/turf_decal/stripes/line{
	dir = 4
	},
/obj/machinery/atmospherics/pipe/smart/manifold4w/cyan/hidden/layer4,
/turf/open/floor/engine,
/area/station/cargo/exploration_office)
"GL" = (
/obj/effect/turf_decal/tile/neutral/half/contrasted{
	dir = 1
	},
/obj/machinery/atmospherics/pipe/smart/manifold4w/cyan/hidden,
/obj/machinery/meter,
/obj/structure/cable,
/turf/open/floor/iron,
/area/station/maintenance/port/fore)
"Hg" = (
/obj/effect/landmark/start/explorer,
/obj/effect/turf_decal/stripes/line{
	dir = 1
	},
/turf/open/floor/engine,
/area/station/cargo/exploration_office)
"IC" = (
/obj/machinery/airalarm/directional/south,
/obj/structure/table/reinforced,
/obj/machinery/recharger{
	pixel_x = -9;
	pixel_y = 7
	},
/obj/machinery/cell_charger{
	pixel_x = 3
	},
/turf/open/floor/iron,
/area/station/cargo/exploration_office)
"Jp" = (
/obj/effect/turf_decal/tile/neutral/opposingcorners,
/obj/machinery/atmospherics/pipe/smart/manifold4w/cyan/hidden,
/obj/structure/cable,
/turf/open/floor/iron,
/area/station/hallway/secondary/entry)
"Jz" = (
/obj/effect/turf_decal/stripes/line{
	dir = 8
	},
/turf/open/floor/engine,
/area/station/cargo/exploration_office)
"LA" = (
/obj/structure/lattice/catwalk,
/obj/structure/sign/warning/directional/east,
/obj/structure/railing{
	dir = 8
	},
/turf/open/space/basic,
/area/space/nearstation)
"Ml" = (
/obj/effect/turf_decal/stripes/line{
	dir = 5
	},
/turf/open/floor/engine,
/area/station/cargo/exploration_office)
"MJ" = (
/obj/docking_port/stationary{
	dir = 8;
	dwidth = 11;
	height = 24;
	name = "SS13: Auxiliary Dock, Station-Fore";
	shuttle_id = "whiteship_home";
	width = 35
	},
/turf/open/space/basic,
/area/template_noop)
"MZ" = (
/obj/effect/turf_decal/stripes/line,
/obj/effect/turf_decal/stripes/line{
	dir = 1
	},
/obj/machinery/door/airlock/external{
	name = "Exploration Office Airlock"
	},
/obj/effect/mapping_helpers/airlock/access/all/command/gateway,
/obj/effect/mapping_helpers/airlock/cyclelink_helper{
	dir = 4
	},
/turf/open/floor/iron,
/area/station/cargo/exploration_office)
"Ni" = (
/obj/effect/turf_decal/stripes/line,
/obj/effect/decal/cleanable/blood/oil,
/turf/open/floor/engine,
/area/station/cargo/exploration_office)
"Nv" = (
/obj/structure/lattice/catwalk,
/turf/open/space/basic,
/area/space/nearstation)
"NZ" = (
/obj/machinery/dive_anchor/stationary,
/obj/effect/turf_decal/stripes/box,
/turf/open/floor/engine,
/area/station/cargo/exploration_office)
"Pi" = (
/obj/structure/lattice/catwalk,
/obj/structure/marker_beacon/indigo{
	pixel_x = -12;
	pixel_y = -12
	},
/obj/structure/railing{
	dir = 1
	},
/turf/open/space/basic,
/area/space/nearstation)
"PE" = (
/obj/structure/lattice/catwalk,
/obj/structure/marker_beacon/indigo{
	pixel_x = -12;
	pixel_y = 15
	},
/turf/open/space/basic,
/area/space/nearstation)
"PU" = (
/obj/structure/sign/warning/doors/directional/east,
/obj/structure/lattice/catwalk,
/obj/structure/railing{
	dir = 8
	},
/turf/open/space/basic,
/area/space/nearstation)
"Qo" = (
/obj/effect/spawner/structure/window/reinforced,
/turf/open/floor/plating,
/area/station/cargo/exploration_office)
"SN" = (
/obj/effect/turf_decal/stripes/line,
/obj/effect/turf_decal/stripes/line{
	dir = 1
	},
/obj/machinery/door/airlock/external{
	name = "Exploration Office Airlock"
	},
/obj/machinery/atmospherics/pipe/smart/manifold4w/scrubbers/hidden/layer2,
/obj/machinery/atmospherics/pipe/smart/manifold4w/cyan/hidden/layer4,
/obj/effect/mapping_helpers/airlock/access/all/command/gateway,
/obj/effect/mapping_helpers/airlock/cyclelink_helper{
	dir = 8
	},
/turf/open/floor/iron,
/area/station/cargo/exploration_office)
"Uz" = (
/obj/machinery/atmospherics/components/unary/vent_pump/on/layer4,
/obj/machinery/atmospherics/pipe/smart/manifold4w/cyan/hidden,
/turf/open/floor/iron,
/area/station/cargo/exploration_office)
"Vn" = (
/turf/closed/wall,
/area/station/cargo/exploration_office)
"Vx" = (
/obj/structure/chair/office{
	dir = 1
	},
/obj/effect/landmark/start/explorer,
/obj/machinery/atmospherics/pipe/layer_manifold/cyan/hidden{
	dir = 8
	},
/turf/open/floor/iron,
/area/station/cargo/exploration_office)
"VA" = (
/obj/structure/lattice/catwalk,
/obj/structure/marker_beacon/indigo{
	pixel_x = 14;
	pixel_y = 15
	},
/obj/structure/railing{
	dir = 8
	},
/turf/open/space/basic,
/area/space/nearstation)
"VP" = (
/obj/structure/extinguisher_cabinet/directional/south,
/obj/structure/cable,
/obj/machinery/atmospherics/pipe/smart/manifold4w/scrubbers/hidden/layer2,
/obj/machinery/atmospherics/pipe/smart/manifold4w/cyan/hidden/layer4,
/obj/effect/landmark/start/explorer,
/obj/item/kirbyplants/random{
	pixel_x = 10
	},
/turf/open/floor/iron,
/area/station/cargo/exploration_office)
"Wp" = (
/obj/structure/sign/warning/vacuum/external/directional/south,
/obj/machinery/atmospherics/pipe/smart/manifold4w/scrubbers/hidden/layer2,
/obj/machinery/atmospherics/pipe/smart/manifold4w/cyan/hidden/layer4,
/turf/open/floor/iron,
/area/station/cargo/exploration_office)

(1,1,1) = {"
sD
sD
sD
sD
sD
sD
sD
sD
sD
sD
sD
sD
sD
sD
sD
sD
sD
sD
sD
sD
sD
"}
(2,1,1) = {"
sD
sD
sD
sD
sD
sD
sD
sD
sD
sD
sD
sD
sD
sD
pW
pW
pW
pW
pW
sD
sD
"}
(3,1,1) = {"
sD
sD
sD
sD
sD
sD
sD
sD
sD
sD
sD
sD
sD
vF
qQ
VA
LA
oJ
PU
pW
sD
"}
(4,1,1) = {"
sD
sD
sD
sD
sD
sD
sD
sD
sD
sD
sD
sD
sD
jG
kS
Nv
Vn
MZ
Vn
pW
sD
"}
(5,1,1) = {"
sD
sD
sD
sD
sD
sD
sD
sD
sD
sD
sD
sD
sD
Pi
Nv
PE
Qo
en
Vn
mx
sD
"}
(6,1,1) = {"
sD
sD
sD
sD
sD
sD
sD
sD
sD
sD
sD
sD
sD
Qo
Qo
Qo
Vn
SN
Vn
pW
sD
"}
(7,1,1) = {"
sD
sD
sD
sD
sD
sD
sD
sD
sD
sD
sD
sD
sD
Qo
fo
Jz
De
Wp
Vn
pW
sD
"}
(8,1,1) = {"
sD
sD
sD
sD
sD
sD
sD
sD
sD
sD
sD
sD
sD
Qo
Hg
NZ
Ni
ba
Vn
pW
sD
"}
(9,1,1) = {"
sD
sD
sD
sD
sD
sD
sD
sD
sD
sD
sD
sD
sD
Qo
Ml
Ge
wP
VP
Vn
pW
sD
"}
(10,1,1) = {"
sD
sD
sD
sD
sD
sD
sD
sD
sD
sD
sD
sD
sD
Qo
Fw
Vx
fY
lQ
Vn
pW
sD
"}
(11,1,1) = {"
MJ
sD
sD
sD
sD
sD
sD
hc
sD
sD
sD
sD
sD
Vn
zt
Uz
Ck
IC
Vn
pW
sD
"}
(12,1,1) = {"
sD
sD
sD
sD
sD
sD
sD
sD
sD
sD
sD
sD
sD
Vn
Vn
ll
tT
gQ
Vn
sD
sD
"}
(13,1,1) = {"
sD
sD
sD
sD
sD
sD
sD
sD
sD
sD
sD
sD
sD
sD
sD
Er
cs
Er
sD
sD
sD
"}
(14,1,1) = {"
sD
sD
sD
sD
sD
sD
sD
sD
sD
sD
sD
sD
sD
sD
sD
sD
wK
Jp
sf
GL
sD
"}
(15,1,1) = {"
sD
sD
sD
sD
sD
sD
sD
sD
sD
sD
sD
sD
sD
sD
sD
sD
dp
sD
sD
co
sD
"}
(16,1,1) = {"
sD
sD
sD
sD
sD
sD
sD
sD
sD
sD
sD
sD
sD
sD
sD
sD
sD
sD
sD
At
sD
"}
