//MAP CONVERTED BY dmm2tgm.py THIS HEADER COMMENT PREVENTS RECONVERSION, DO NOT REMOVE
"aZ" = (
/obj/structure/table/reinforced,
/obj/item/paper_bin{
	pixel_x = -6;
	pixel_y = 1
	},
/obj/item/reagent_containers/cup/glass/mug{
	pixel_x = -7;
	list_reagents = list(/datum/reagent/consumable/coffee = 10);
	pixel_y = 11
	},
/obj/item/pen,
/obj/machinery/recharger{
	pixel_x = 6;
	pixel_y = 4
	},
/turf/open/floor/iron/smooth_large,
/area/station/cargo/exploration_office)
"bW" = (
/obj/structure/lattice/catwalk,
/obj/structure/marker_beacon/indigo{
	pixel_x = 14;
	pixel_y = -12
	},
/turf/open/space/basic,
/area/space/nearstation)
"dv" = (
/obj/machinery/door/airlock/external/glass{
	name = "Exploration Office Airlock"
	},
/obj/effect/mapping_helpers/airlock/cyclelink_helper{
	dir = 4
	},
/obj/effect/mapping_helpers/airlock/access/any/command/gateway,
/obj/effect/turf_decal/stripes/end{
	dir = 8
	},
/turf/open/floor/iron/smooth_large,
/area/station/cargo/exploration_office)
"dY" = (
/obj/machinery/atmospherics/pipe/smart/manifold4w/scrubbers/hidden/layer2,
/obj/structure/cable,
/obj/machinery/light/directional/west,
/obj/machinery/firealarm/directional/west,
/turf/open/floor/iron/smooth_large,
/area/station/cargo/exploration_office)
"ef" = (
/obj/structure/tank_dispenser/oxygen,
/turf/open/floor/iron/smooth_large,
/area/station/cargo/exploration_office)
"gb" = (
/obj/effect/turf_decal/stripes/box,
/obj/machinery/dive_anchor/stationary,
/turf/open/floor/engine,
/area/station/cargo/exploration_office)
"hG" = (
/turf/closed/wall,
/area/station/cargo/exploration_office)
"ih" = (
/obj/structure/chair/office{
	dir = 4
	},
/obj/effect/landmark/start/explorer,
/turf/open/floor/iron/smooth_large,
/area/station/cargo/exploration_office)
"jw" = (
/obj/machinery/atmospherics/pipe/smart/manifold4w/scrubbers/hidden/layer2,
/obj/structure/cable,
/obj/machinery/light/directional/south,
/turf/open/floor/catwalk_floor/iron_smooth,
/area/station/cargo/exploration_office)
"jX" = (
/obj/structure/cable,
/obj/item/kirbyplants/random{
	pixel_x = 10
	},
/turf/open/floor/catwalk_floor/iron_smooth,
/area/station/cargo/exploration_office)
"kp" = (
/obj/effect/spawner/random/engineering/tracking_beacon,
/turf/open/floor/iron/smooth_large,
/area/station/cargo/exploration_office)
"kX" = (
/obj/effect/turf_decal/stripes/line{
	dir = 5
	},
/turf/open/floor/engine,
/area/station/cargo/exploration_office)
"ob" = (
/obj/effect/turf_decal/stripes/line{
	dir = 6
	},
/turf/open/floor/engine,
/area/station/cargo/exploration_office)
"qm" = (
/obj/machinery/atmospherics/pipe/smart/manifold4w/supply/hidden/layer4,
/obj/machinery/atmospherics/pipe/smart/manifold4w/scrubbers/hidden/layer2,
/obj/structure/cable,
/turf/open/floor/iron/smooth_large,
/area/station/cargo/exploration_office)
"sM" = (
/obj/structure/cable,
/obj/effect/turf_decal/stripes/line{
	dir = 4
	},
/turf/open/floor/iron/smooth_large,
/area/station/cargo/exploration_office)
"tT" = (
/obj/structure/closet/crate/bin,
/obj/effect/spawner/random/trash/garbage,
/obj/effect/spawner/random/trash/garbage,
/turf/open/floor/iron/smooth_large,
/area/station/cargo/exploration_office)
"uS" = (
/turf/open/floor/iron/smooth_large,
/area/station/cargo/exploration_office)
"vq" = (
/obj/structure/lattice/catwalk,
/obj/structure/marker_beacon/indigo{
	pixel_x = -12;
	pixel_y = 15
	},
/turf/open/space/basic,
/area/space/nearstation)
"vG" = (
/obj/structure/cable,
/turf/open/floor/catwalk_floor/iron_smooth,
/area/station/cargo/exploration_office)
"wp" = (
/obj/machinery/suit_storage_unit/explorer,
/obj/effect/turf_decal/bot,
/turf/open/floor/iron/smooth_large,
/area/station/cargo/exploration_office)
"ye" = (
/obj/machinery/atmospherics/pipe/smart/manifold4w/scrubbers/hidden/layer2,
/obj/structure/cable,
/turf/open/floor/catwalk_floor/iron_smooth,
/area/station/cargo/exploration_office)
"zm" = (
/obj/structure/cable,
/obj/machinery/light/directional/east,
/obj/effect/turf_decal/stripes/corner{
	dir = 4
	},
/turf/open/floor/iron/smooth_large,
/area/station/cargo/exploration_office)
"zA" = (
/obj/machinery/atmospherics/pipe/smart/manifold4w/supply/hidden/layer4,
/obj/machinery/atmospherics/pipe/smart/manifold4w/scrubbers/hidden/layer2,
/obj/structure/cable,
/turf/open/floor/catwalk_floor/iron_smooth,
/area/station/maintenance/aft/upper)
"AA" = (
/obj/machinery/atmospherics/components/unary/vent_pump/on/layer4{
	dir = 1
	},
/obj/item/kirbyplants/random{
	pixel_x = 13
	},
/turf/open/floor/iron/smooth_large,
/area/station/cargo/exploration_office)
"AS" = (
/obj/structure/rack,
/obj/item/multitool{
	pixel_x = -7;
	pixel_y = 2
	},
/obj/item/stack/impure_telecrystal{
	pixel_x = -6;
	pixel_y = -2
	},
/obj/item/stack/rods{
	pixel_x = 4;
	amount = 20
	},
/turf/open/floor/iron/smooth_large,
/area/station/cargo/exploration_office)
"CS" = (
/obj/machinery/atmospherics/pipe/smart/manifold4w/supply/hidden/layer4,
/obj/structure/cable,
/turf/open/floor/catwalk_floor/iron_smooth,
/area/station/cargo/exploration_office)
"Dh" = (
/obj/effect/turf_decal/stripes/line{
	dir = 4
	},
/obj/effect/landmark/start/explorer,
/turf/open/floor/engine,
/area/station/cargo/exploration_office)
"Dy" = (
/obj/effect/spawner/structure/window/reinforced,
/turf/open/floor/plating,
/area/station/maintenance/aft/upper)
"Eg" = (
/obj/effect/turf_decal/stripes/line{
	dir = 8
	},
/turf/open/floor/engine,
/area/station/cargo/exploration_office)
"EM" = (
/obj/structure/lattice/catwalk,
/obj/structure/marker_beacon/indigo{
	pixel_x = -12;
	pixel_y = -12
	},
/turf/open/space/basic,
/area/space/nearstation)
"Fx" = (
/obj/machinery/atmospherics/components/unary/vent_scrubber/on/layer2,
/obj/item/kirbyplants/random{
	pixel_x = -13
	},
/turf/open/floor/iron/smooth_large,
/area/station/cargo/exploration_office)
"FC" = (
/obj/machinery/dive_anchor,
/turf/open/space/basic,
/area/space/nearstation)
"FK" = (
/obj/machinery/atmospherics/pipe/smart/manifold4w/supply/hidden/layer4,
/obj/structure/cable,
/obj/machinery/light/directional/west,
/obj/machinery/light_switch/directional/west,
/turf/open/floor/iron/smooth_large,
/area/station/cargo/exploration_office)
"Hd" = (
/obj/structure/sign/warning/vacuum/external/directional/north,
/obj/structure/extinguisher_cabinet/directional/south,
/obj/machinery/light/floor,
/obj/effect/turf_decal/stripes/line,
/obj/effect/turf_decal/stripes/line{
	dir = 1
	},
/turf/open/floor/iron/smooth_large,
/area/station/cargo/exploration_office)
"Hn" = (
/obj/effect/mapping_helpers/airlock/cyclelink_helper{
	dir = 8
	},
/obj/machinery/door/airlock/external{
	name = "Exploration Office Airlock"
	},
/obj/effect/mapping_helpers/airlock/access/any/command/gateway,
/obj/effect/turf_decal/stripes/end{
	dir = 4
	},
/turf/open/floor/iron/smooth_large,
/area/station/cargo/exploration_office)
"HE" = (
/obj/machinery/atmospherics/pipe/smart/manifold4w/supply/hidden/layer4,
/obj/structure/cable,
/obj/machinery/light/directional/north,
/turf/open/floor/catwalk_floor/iron_smooth,
/area/station/cargo/exploration_office)
"HS" = (
/obj/structure/cable,
/obj/item/kirbyplants/random{
	pixel_x = 10;
	pixel_y = 18
	},
/obj/machinery/camera/autoname/directional/north,
/turf/open/floor/catwalk_floor/iron_smooth,
/area/station/cargo/exploration_office)
"HU" = (
/obj/structure/cable,
/obj/machinery/light/directional/east,
/obj/effect/turf_decal/stripes/corner,
/turf/open/floor/iron/smooth_large,
/area/station/cargo/exploration_office)
"IC" = (
/obj/machinery/atmospherics/pipe/smart/manifold4w/supply/hidden/layer4,
/obj/structure/cable,
/obj/machinery/airalarm/directional/north,
/turf/open/floor/catwalk_floor/iron_smooth,
/area/station/cargo/exploration_office)
"IT" = (
/obj/machinery/atmospherics/components/unary/vent_pump/on/layer4{
	dir = 1
	},
/obj/effect/turf_decal/stripes/line{
	dir = 1
	},
/turf/open/floor/engine,
/area/station/cargo/exploration_office)
"Jz" = (
/obj/effect/landmark/carpspawn,
/turf/open/space/basic,
/area/space)
"Kf" = (
/obj/structure/lattice/catwalk,
/turf/open/space/basic,
/area/space/nearstation)
"Ku" = (
/obj/structure/cable,
/obj/machinery/atmospherics/pipe/smart/manifold4w/scrubbers/hidden/layer2,
/obj/machinery/atmospherics/pipe/smart/manifold4w/supply/hidden/layer4,
/turf/open/floor/catwalk_floor/iron_smooth,
/area/station/maintenance/aft/upper)
"KR" = (
/obj/structure/lattice,
/turf/open/space/basic,
/area/space/nearstation)
"Le" = (
/obj/structure/lattice/catwalk,
/obj/structure/marker_beacon/indigo{
	pixel_x = 14;
	pixel_y = 15
	},
/obj/structure/sign/warning/directional/west,
/turf/open/space/basic,
/area/space/nearstation)
"Lv" = (
/obj/machinery/computer/anchor_controller{
	dir = 8
	},
/turf/open/floor/iron/smooth_large,
/area/station/cargo/exploration_office)
"Ma" = (
/obj/machinery/atmospherics/pipe/smart/manifold4w/supply/hidden/layer4,
/obj/structure/cable,
/obj/structure/closet/firecloset/wall{
	pixel_y = 26
	},
/turf/open/floor/catwalk_floor/iron_smooth,
/area/station/cargo/exploration_office)
"Nn" = (
/turf/template_noop,
/area/template_noop)
"Pm" = (
/obj/effect/turf_decal/stripes/line{
	dir = 10
	},
/turf/open/floor/engine,
/area/station/cargo/exploration_office)
"Rj" = (
/mob/living/basic/pet/cat/space{
	name = "Lem";
	gender = "male";
	unique_pet = 1;
	desc = "He's kittened out for space exploration."
	},
/obj/structure/bed/dogbed{
	name = "Lem's bed";
	desc = "A comfy-looking cat bed. You can even strap your pet in, in case the gravity turns off."
	},
/turf/open/floor/iron/smooth_large,
/area/station/cargo/exploration_office)
"Rs" = (
/obj/structure/table/reinforced,
/obj/machinery/cell_charger,
/turf/open/floor/iron/smooth_large,
/area/station/cargo/exploration_office)
"TQ" = (
/obj/machinery/atmospherics/pipe/smart/manifold4w/scrubbers/hidden/layer2,
/obj/structure/cable,
/obj/machinery/camera/autoname/directional/south,
/turf/open/floor/catwalk_floor/iron_smooth,
/area/station/cargo/exploration_office)
"Wn" = (
/obj/structure/cable,
/obj/machinery/atmospherics/pipe/smart/manifold4w/scrubbers/hidden/layer2,
/obj/machinery/atmospherics/pipe/smart/manifold4w/supply/hidden/layer4,
/obj/effect/mapping_helpers/airlock/access/any/command/gateway,
/obj/machinery/door/airlock/mining{
	name = "Exploration Office"
	},
/obj/machinery/door/firedoor,
/obj/effect/landmark/navigate_destination/exploration_office,
/turf/open/floor/catwalk_floor/iron_smooth,
/area/station/cargo/exploration_office)
"Xv" = (
/obj/machinery/atmospherics/components/unary/vent_scrubber/on/layer2,
/obj/effect/turf_decal/stripes/line,
/turf/open/floor/engine,
/area/station/cargo/exploration_office)
"Yc" = (
/obj/effect/turf_decal/stripes/line{
	dir = 9
	},
/obj/effect/decal/cleanable/blood/oil,
/turf/open/floor/engine,
/area/station/cargo/exploration_office)
"Zs" = (
/obj/effect/landmark/start/explorer,
/turf/open/floor/iron/smooth_large,
/area/station/cargo/exploration_office)
"Zx" = (
/obj/machinery/atmospherics/pipe/smart/manifold4w/scrubbers/hidden/layer2,
/obj/structure/cable,
/obj/machinery/power/apc/auto_name/directional/south,
/turf/open/floor/catwalk_floor/iron_smooth,
/area/station/cargo/exploration_office)
"ZK" = (
/obj/effect/spawner/structure/window/reinforced,
/turf/open/floor/plating,
/area/station/cargo/exploration_office)

(1,1,1) = {"
Nn
Nn
Nn
Nn
Nn
Nn
zA
Nn
Nn
Nn
Nn
"}
(2,1,1) = {"
Nn
Nn
Nn
Nn
Nn
Dy
Ku
Dy
Nn
Nn
KR
"}
(3,1,1) = {"
Nn
Nn
KR
hG
hG
hG
Wn
hG
hG
hG
KR
"}
(4,1,1) = {"
Nn
Nn
KR
hG
Ma
FK
qm
dY
TQ
hG
KR
"}
(5,1,1) = {"
Nn
Nn
KR
ZK
CS
wp
uS
ef
ye
ZK
KR
"}
(6,1,1) = {"
Nn
Nn
KR
ZK
CS
AA
Zs
Fx
ye
ZK
KR
"}
(7,1,1) = {"
Nn
Nn
KR
ZK
CS
wp
uS
AS
ye
ZK
KR
"}
(8,1,1) = {"
Nn
Nn
KR
hG
HE
uS
kp
uS
jw
hG
KR
"}
(9,1,1) = {"
Nn
Nn
KR
hG
IC
Rj
ih
tT
Zx
hG
KR
"}
(10,1,1) = {"
Nn
Nn
KR
hG
HE
Rs
Lv
aZ
jw
hG
KR
"}
(11,1,1) = {"
Nn
Nn
KR
ZK
CS
Yc
Eg
Pm
ye
ZK
KR
"}
(12,1,1) = {"
Jz
Nn
KR
ZK
CS
IT
gb
Xv
ye
ZK
KR
"}
(13,1,1) = {"
Nn
Nn
KR
ZK
vG
kX
Dh
ob
vG
ZK
KR
"}
(14,1,1) = {"
Nn
Nn
KR
hG
HS
HU
sM
zm
jX
hG
KR
"}
(15,1,1) = {"
Nn
Nn
KR
hG
hG
hG
dv
hG
hG
hG
KR
"}
(16,1,1) = {"
Nn
Nn
KR
KR
KR
hG
Hd
hG
KR
KR
KR
"}
(17,1,1) = {"
Nn
Nn
Nn
KR
Nn
hG
Hn
hG
Nn
KR
Jz
"}
(18,1,1) = {"
Nn
Nn
Nn
KR
KR
bW
Kf
Le
KR
KR
Nn
"}
(19,1,1) = {"
Nn
Nn
Nn
KR
Nn
Kf
FC
Kf
Nn
KR
Nn
"}
(20,1,1) = {"
Nn
Nn
Nn
KR
KR
EM
Kf
vq
KR
KR
Nn
"}
(21,1,1) = {"
Nn
Nn
Nn
Nn
KR
KR
Nn
KR
KR
Nn
Nn
"}
(22,1,1) = {"
Nn
Nn
Nn
Nn
Nn
KR
KR
KR
Nn
Nn
Nn
"}
