//MAP CONVERTED BY dmm2tgm.py THIS HEADER COMMENT PREVENTS RECONVERSION, DO NOT REMOVE
"ap" = (
/obj/machinery/door/airlock/external/glass{
	name = "Exploration Office Airlock"
	},
/obj/effect/mapping_helpers/airlock/access/any/command/gateway,
/obj/effect/mapping_helpers/airlock/cyclelink_helper_multi{
	cycle_id = "exploration-office-airlock"
	},
/obj/effect/turf_decal/stripes/line,
/obj/effect/turf_decal/stripes/line{
	dir = 1
	},
/obj/machinery/atmospherics/pipe/smart/manifold4w/supply/hidden,
/turf/open/floor/iron/smooth_large,
/area/station/cargo/exploration_office)
"bI" = (
/obj/structure/cable,
/obj/machinery/atmospherics/pipe/smart/manifold4w/supply/hidden/layer4,
/obj/machinery/atmospherics/pipe/smart/manifold4w/scrubbers/hidden/layer2,
/turf/open/floor/catwalk_floor/iron_smooth,
/area/station/cargo/miningfoundry)
"bJ" = (
/obj/effect/turf_decal/stripes/line,
/turf/open/floor/engine,
/area/station/cargo/exploration_office)
"cJ" = (
/obj/structure/lattice,
/obj/structure/sign/warning/directional/north,
/turf/open/space/basic,
/area/space/nearstation)
"eW" = (
/turf/open/space/basic,
/area/space)
"fb" = (
/obj/effect/turf_decal/stripes/line{
	dir = 4
	},
/turf/open/floor/engine,
/area/station/cargo/exploration_office)
"fp" = (
/obj/effect/decal/cleanable/dirt,
/obj/structure/sign/poster/official/random/directional/west{
	pixel_x = -27
	},
/obj/structure/closet/toolcloset{
	dir = 4
	},
/obj/item/storage/box/nri_flares,
/obj/effect/turf_decal/bot,
/turf/open/floor/iron/smooth_edge{
	dir = 8
	},
/area/station/cargo/exploration_office)
"gR" = (
/obj/effect/spawner/random/engineering/tracking_beacon,
/obj/machinery/atmospherics/pipe/smart/manifold4w/supply/hidden/layer4,
/turf/open/floor/catwalk_floor/iron_smooth,
/area/station/cargo/exploration_office)
"gZ" = (
/obj/effect/turf_decal/stripes/line{
	dir = 8
	},
/turf/open/floor/engine,
/area/station/cargo/exploration_office)
"hv" = (
/obj/machinery/computer/anchor_controller{
	dir = 1
	},
/obj/structure/railing{
	dir = 4
	},
/obj/effect/turf_decal/stripes/corner,
/turf/open/floor/iron/smooth_edge{
	dir = 4
	},
/area/station/cargo/exploration_office)
"hB" = (
/obj/effect/turf_decal/stripes/line{
	dir = 5
	},
/turf/open/floor/engine,
/area/station/cargo/exploration_office)
"iK" = (
/obj/structure/lattice/catwalk,
/obj/structure/marker_beacon/indigo{
	pixel_x = 14;
	pixel_y = -12
	},
/turf/open/space/basic,
/area/space/nearstation)
"jh" = (
/obj/machinery/door/airlock/mining{
	name = "Exploration Office"
	},
/obj/effect/mapping_helpers/airlock/access/any/command/gateway,
/obj/machinery/door/firedoor,
/obj/effect/turf_decal/stripes/line{
	dir = 4
	},
/obj/effect/turf_decal/stripes/line{
	dir = 8
	},
/obj/machinery/atmospherics/pipe/smart/manifold4w/supply/hidden/layer4,
/obj/machinery/atmospherics/pipe/smart/manifold4w/scrubbers/hidden/layer2,
/obj/structure/cable,
/obj/effect/landmark/navigate_destination/exploration_office,
/turf/open/floor/iron/smooth_large,
/area/station/cargo/exploration_office)
"js" = (
/obj/structure/table/reinforced,
/obj/machinery/recharger{
	pixel_y = 8
	},
/obj/item/storage/medkit/emergency{
	pixel_y = -12;
	pixel_x = 2
	},
/obj/machinery/airalarm/directional/west,
/turf/open/floor/iron/smooth_edge{
	dir = 8
	},
/area/station/cargo/exploration_office)
"jS" = (
/obj/effect/turf_decal/stripes/line,
/obj/effect/turf_decal/caution{
	dir = 1
	},
/turf/open/floor/iron/smooth_edge,
/area/station/cargo/exploration_office)
"mq" = (
/obj/effect/turf_decal/stripes/box,
/obj/machinery/dive_anchor/stationary,
/turf/open/floor/engine,
/area/station/cargo/exploration_office)
"mQ" = (
/obj/effect/turf_decal/stripes/line{
	dir = 6
	},
/turf/open/floor/iron/smooth,
/area/station/cargo/exploration_office)
"mV" = (
/obj/machinery/power/apc/auto_name/directional/east,
/obj/machinery/atmospherics/pipe/smart/manifold4w/scrubbers/hidden/layer2,
/obj/structure/cable,
/turf/open/floor/catwalk_floor/iron_smooth,
/area/station/cargo/exploration_office)
"nd" = (
/obj/structure/lattice/catwalk,
/obj/structure/marker_beacon/teal,
/turf/open/space/basic,
/area/space/nearstation)
"no" = (
/turf/template_noop,
/area/template_noop)
"oX" = (
/obj/effect/turf_decal/stripes/line{
	dir = 4
	},
/obj/effect/turf_decal/stripes/line{
	dir = 8
	},
/obj/machinery/atmospherics/pipe/smart/manifold4w/supply/hidden/layer4,
/obj/machinery/atmospherics/pipe/smart/manifold4w/scrubbers/hidden/layer2,
/obj/structure/cable,
/obj/effect/mapping_helpers/airlock/access/any/supply/mining,
/obj/machinery/door/airlock/mining{
	name = "Mining Foundry"
	},
/obj/machinery/door/firedoor,
/obj/effect/mapping_helpers/airlock/access/any/command/gateway,
/turf/open/floor/catwalk_floor/iron_smooth,
/area/station/cargo/miningfoundry)
"pA" = (
/obj/machinery/light_switch/directional/west{
	pixel_x = -20;
	pixel_y = 7
	},
/obj/structure/table/reinforced,
/obj/item/storage/box/colonial_rations{
	pixel_y = 9;
	pixel_x = -6
	},
/obj/item/storage/box/colonial_rations{
	pixel_y = 2;
	pixel_x = -6
	},
/turf/open/floor/iron/smooth_edge{
	dir = 8
	},
/area/station/cargo/exploration_office)
"qC" = (
/obj/machinery/atmospherics/pipe/smart/manifold4w/supply/hidden/layer4,
/obj/effect/turf_decal/stripes/line,
/obj/structure/cable,
/obj/machinery/atmospherics/pipe/smart/manifold4w/scrubbers/hidden/layer2,
/turf/open/floor/catwalk_floor/iron_smooth,
/area/station/cargo/miningfoundry)
"rs" = (
/obj/machinery/atmospherics/pipe/smart/manifold4w/supply/hidden/layer4,
/obj/machinery/atmospherics/pipe/smart/manifold4w/scrubbers/hidden/layer2,
/obj/structure/cable,
/turf/open/floor/catwalk_floor/iron_smooth,
/area/station/cargo/exploration_office)
"tK" = (
/obj/effect/turf_decal/stripes/line{
	dir = 9
	},
/obj/machinery/shower/directional/east,
/turf/open/floor/iron/smooth,
/area/station/cargo/exploration_office)
"tL" = (
/obj/structure/lattice/catwalk,
/obj/structure/marker_beacon/indigo{
	pixel_x = 14;
	pixel_y = 15
	},
/obj/structure/sign/warning/directional/west,
/obj/structure/railing,
/turf/open/space/basic,
/area/space/nearstation)
"tS" = (
/obj/effect/spawner/structure/window/reinforced,
/turf/open/floor/plating,
/area/station/cargo/exploration_office)
"uO" = (
/obj/structure/chair/office{
	dir = 4
	},
/obj/structure/railing/corner,
/obj/effect/landmark/start/explorer,
/obj/effect/decal/cleanable/dirt,
/turf/open/floor/iron/smooth,
/area/station/cargo/exploration_office)
"uR" = (
/obj/effect/turf_decal/stripes/line{
	dir = 5
	},
/obj/machinery/atmospherics/components/unary/vent_pump/on{
	dir = 1
	},
/obj/structure/sign/poster/official/safety_internals/directional/east{
	pixel_x = 27;
	pixel_y = 4
	},
/turf/open/floor/iron/smooth,
/area/station/cargo/exploration_office)
"vk" = (
/obj/effect/turf_decal/stripes/line{
	dir = 6
	},
/turf/open/floor/engine,
/area/station/cargo/exploration_office)
"wl" = (
/obj/structure/lattice/catwalk,
/obj/structure/railing/corner/end{
	dir = 1
	},
/obj/structure/railing/corner/end/flip,
/turf/open/space/basic,
/area/space/nearstation)
"wB" = (
/obj/effect/turf_decal/stripes/line{
	dir = 10
	},
/obj/machinery/camera/directional/east{
	c_tag = "Cargo - Exploration Office";
	dir = 2
	},
/turf/open/floor/engine,
/area/station/cargo/exploration_office)
"wU" = (
/obj/effect/turf_decal/stripes/line{
	dir = 1
	},
/turf/open/floor/engine,
/area/station/cargo/exploration_office)
"xT" = (
/obj/machinery/atmospherics/pipe/smart/manifold4w/supply/hidden,
/obj/effect/landmark/start/explorer,
/turf/open/floor/catwalk_floor/iron_smooth,
/area/station/cargo/exploration_office)
"xW" = (
/obj/structure/lattice,
/turf/open/space/basic,
/area/space/nearstation)
"yM" = (
/obj/structure/cable,
/obj/machinery/atmospherics/pipe/smart/manifold4w/supply/hidden/layer4,
/obj/machinery/atmospherics/pipe/smart/manifold4w/scrubbers/hidden/layer2,
/obj/structure/extinguisher_cabinet/directional/north,
/turf/open/floor/catwalk_floor/iron_smooth,
/area/station/cargo/miningfoundry)
"zu" = (
/obj/structure/closet/crate/bin,
/obj/effect/spawner/random/trash/garbage,
/obj/effect/spawner/random/trash/garbage,
/obj/structure/sign/poster/official/random/directional/north,
/turf/open/floor/iron/smooth_large,
/area/station/cargo/exploration_office)
"zI" = (
/obj/effect/decal/cleanable/dirt,
/turf/open/floor/iron/smooth,
/area/station/cargo/exploration_office)
"BJ" = (
/obj/structure/railing{
	dir = 4
	},
/obj/effect/turf_decal/stripes/corner{
	dir = 4
	},
/obj/machinery/portable_atmospherics/canister/oxygen,
/obj/effect/turf_decal/bot_blue,
/turf/open/floor/iron/smooth_corner{
	dir = 1
	},
/area/station/cargo/exploration_office)
"Cr" = (
/obj/effect/decal/cleanable/dirt,
/obj/effect/landmark/start/explorer,
/turf/open/floor/iron/smooth,
/area/station/cargo/exploration_office)
"CA" = (
/obj/effect/turf_decal/stripes/line{
	dir = 4
	},
/obj/effect/turf_decal/caution{
	dir = 8
	},
/obj/effect/decal/cleanable/dirt,
/turf/open/floor/iron/smooth_edge{
	dir = 4
	},
/area/station/cargo/exploration_office)
"CN" = (
/obj/structure/lattice/catwalk,
/obj/structure/railing/corner/end{
	dir = 4
	},
/obj/structure/railing/corner/end/flip{
	dir = 8
	},
/turf/open/space/basic,
/area/space/nearstation)
"Dr" = (
/obj/machinery/atmospherics/pipe/smart/manifold4w/scrubbers/hidden/layer2,
/obj/structure/cable,
/turf/open/floor/catwalk_floor/iron_smooth,
/area/station/cargo/exploration_office)
"ER" = (
/obj/structure/rack/gunrack,
/obj/item/gun/ballistic/shotgun/toy,
/obj/structure/sign/poster/official/random/directional/west{
	pixel_x = -27;
	pixel_y = 5
	},
/turf/open/floor/iron/smooth_edge{
	dir = 8
	},
/area/station/cargo/exploration_office)
"Gg" = (
/obj/machinery/firealarm/directional/east{
	pixel_x = 19
	},
/obj/machinery/atmospherics/components/unary/vent_scrubber/on/layer2{
	dir = 1
	},
/obj/item/kirbyplants/random,
/turf/open/floor/iron/smooth_edge{
	dir = 4
	},
/area/station/cargo/exploration_office)
"HX" = (
/obj/structure/lattice/catwalk,
/obj/structure/marker_beacon/indigo{
	pixel_x = -12;
	pixel_y = 15
	},
/obj/structure/railing{
	dir = 6
	},
/turf/open/space/basic,
/area/space/nearstation)
"Is" = (
/obj/structure/rack,
/obj/item/multitool{
	pixel_x = -7;
	pixel_y = 2
	},
/obj/item/stack/impure_telecrystal{
	pixel_x = -6;
	pixel_y = -2
	},
/obj/item/stack/rods/twentyfive{
	pixel_x = 4
	},
/turf/open/floor/iron/smooth_corner{
	dir = 4
	},
/area/station/cargo/exploration_office)
"Iz" = (
/obj/machinery/door/airlock/mining{
	name = "Mining Dock"
	},
/obj/machinery/atmospherics/pipe/smart/manifold4w/supply/hidden/layer4,
/obj/machinery/atmospherics/pipe/smart/manifold4w/scrubbers/hidden/layer2,
/obj/structure/cable,
/obj/machinery/door/firedoor,
/obj/effect/turf_decal/stripes/line,
/obj/effect/turf_decal/stripes/line{
	dir = 1
	},
/obj/structure/disposalpipe/segment,
/obj/effect/mapping_helpers/airlock/access/any/supply/mining,
/obj/effect/mapping_helpers/airlock/access/any/supply/bit_den,
/obj/effect/mapping_helpers/airlock/access/any/command/gateway,
/turf/open/floor/iron/smooth,
/area/station/cargo/miningdock)
"Jp" = (
/obj/structure/table/reinforced,
/obj/machinery/cell_charger,
/obj/machinery/light/directional/west,
/turf/open/floor/iron/smooth_edge{
	dir = 8
	},
/area/station/cargo/exploration_office)
"Od" = (
/obj/effect/turf_decal/stripes/line{
	dir = 10
	},
/obj/structure/closet/firecloset/wall{
	pixel_x = -25
	},
/obj/machinery/light/floor,
/turf/open/floor/iron/smooth,
/area/station/cargo/exploration_office)
"Oj" = (
/obj/effect/spawner/random/structure/grille,
/turf/open/floor/plating/airless,
/area/space/nearstation)
"OX" = (
/obj/machinery/light/directional/east,
/obj/structure/bed/dogbed{
	name = "Lem's bed";
	desc = "A comfy-looking cat bed. You can even strap your pet in, in case the gravity turns off."
	},
/mob/living/basic/pet/cat/space{
	name = "Lem";
	gender = "male";
	unique_pet = 1;
	desc = "He's kittened out for space exploration."
	},
/obj/structure/railing,
/obj/effect/turf_decal/stripes/corner{
	dir = 8
	},
/turf/open/floor/iron/smooth_corner{
	dir = 1
	},
/area/station/cargo/exploration_office)
"RB" = (
/obj/structure/lattice/catwalk,
/turf/open/space/basic,
/area/space/nearstation)
"Ss" = (
/obj/machinery/atmospherics/components/unary/vent_pump/on/layer4{
	dir = 1
	},
/turf/open/floor/iron/smooth,
/area/station/cargo/exploration_office)
"Te" = (
/obj/machinery/door/airlock/external{
	name = "Exploration Office Airlock"
	},
/obj/effect/mapping_helpers/airlock/access/any/command/gateway,
/obj/effect/mapping_helpers/airlock/cyclelink_helper_multi{
	cycle_id = "exploration-office-airlock"
	},
/obj/effect/turf_decal/stripes/line{
	dir = 4
	},
/obj/effect/turf_decal/stripes/line{
	dir = 8
	},
/turf/open/floor/iron/smooth_large,
/area/station/cargo/exploration_office)
"TA" = (
/obj/effect/turf_decal/stripes/line{
	dir = 9
	},
/turf/open/floor/engine,
/area/station/cargo/exploration_office)
"Uo" = (
/obj/machinery/dive_anchor,
/turf/open/space/basic,
/area/space/nearstation)
"VI" = (
/obj/structure/lattice/catwalk,
/obj/structure/marker_beacon/indigo{
	pixel_x = -12;
	pixel_y = -12
	},
/obj/structure/railing{
	dir = 4
	},
/turf/open/space/basic,
/area/space/nearstation)
"WX" = (
/obj/machinery/suit_storage_unit/explorer,
/obj/effect/turf_decal/bot,
/turf/open/floor/iron/smooth_large,
/area/station/cargo/exploration_office)
"XM" = (
/obj/machinery/atmospherics/pipe/smart/manifold4w/supply/hidden,
/turf/open/floor/catwalk_floor/iron_smooth,
/area/station/cargo/exploration_office)
"Yl" = (
/obj/machinery/computer/cargo/request{
	dir = 8
	},
/obj/structure/railing,
/obj/effect/turf_decal/stripes/corner,
/turf/open/floor/iron/smooth_corner{
	dir = 1
	},
/area/station/cargo/exploration_office)
"YV" = (
/obj/machinery/conveyor_switch/oneway{
	id = "mining";
	dir = 1
	},
/obj/effect/turf_decal/stripes/line{
	dir = 6
	},
/obj/structure/cable,
/obj/machinery/atmospherics/pipe/smart/manifold4w/supply/hidden/layer4,
/obj/machinery/atmospherics/pipe/smart/manifold4w/scrubbers/hidden/layer2,
/turf/open/floor/catwalk_floor/iron_smooth,
/area/station/cargo/miningfoundry)
"Zg" = (
/turf/closed/wall,
/area/station/cargo/exploration_office)
"Zl" = (
/obj/machinery/atmospherics/pipe/layer_manifold/supply/hidden,
/turf/open/floor/catwalk_floor/iron_smooth,
/area/station/cargo/exploration_office)

(1,1,1) = {"
no
no
no
no
no
no
no
no
no
no
Iz
no
no
no
no
no
no
"}
(2,1,1) = {"
no
no
no
no
no
no
no
no
no
no
no
no
no
no
no
no
no
"}
(3,1,1) = {"
no
no
no
no
no
no
no
no
no
no
no
no
no
no
no
no
no
"}
(4,1,1) = {"
no
no
no
no
no
no
no
no
no
no
no
no
no
no
no
no
no
"}
(5,1,1) = {"
no
no
no
no
no
no
no
no
no
no
no
no
no
no
no
no
no
"}
(6,1,1) = {"
no
no
no
no
no
no
no
no
no
no
no
no
no
no
no
no
no
"}
(7,1,1) = {"
no
no
no
no
no
no
no
no
no
no
no
no
no
no
no
no
no
"}
(8,1,1) = {"
no
no
no
no
no
no
no
no
no
no
no
no
no
no
no
no
no
"}
(9,1,1) = {"
no
no
no
no
no
no
no
no
oX
no
no
no
no
no
no
no
no
"}
(10,1,1) = {"
no
no
no
no
no
no
no
no
no
no
no
no
no
no
no
no
no
"}
(11,1,1) = {"
no
no
no
no
no
no
no
no
no
no
no
no
no
no
no
no
no
"}
(12,1,1) = {"
no
no
no
no
no
no
no
no
qC
no
no
no
no
no
no
no
no
"}
(13,1,1) = {"
no
no
no
no
no
no
bI
bI
YV
no
no
no
no
no
no
no
no
"}
(14,1,1) = {"
no
no
no
no
no
no
yM
no
no
no
no
no
no
no
no
no
no
"}
(15,1,1) = {"
eW
eW
Oj
eW
no
Zg
jh
Zg
Zg
Zg
Zg
Zg
Zg
Zg
Zg
Zg
Zg
"}
(16,1,1) = {"
nd
xW
Oj
xW
xW
Zg
rs
fp
pA
js
Jp
ER
Is
Zg
tK
Od
tS
"}
(17,1,1) = {"
no
no
Oj
eW
xW
tS
rs
rs
gR
Zl
XM
xT
XM
ap
uR
mQ
tS
"}
(18,1,1) = {"
no
no
Oj
eW
xW
tS
WX
rs
zI
uO
hv
CA
BJ
Zg
Zg
Te
Zg
"}
(19,1,1) = {"
nd
xW
Oj
xW
xW
tS
WX
rs
Ss
Yl
TA
gZ
wB
tS
iK
RB
tL
"}
(20,1,1) = {"
no
no
Oj
no
xW
tS
WX
Dr
Cr
jS
wU
mq
bJ
tS
RB
Uo
CN
"}
(21,1,1) = {"
no
no
Oj
no
xW
Zg
zu
mV
Gg
OX
hB
fb
vk
tS
VI
wl
HX
"}
(22,1,1) = {"
nd
xW
Oj
xW
xW
Zg
Zg
Zg
Zg
Zg
tS
tS
tS
Zg
cJ
xW
xW
"}
(23,1,1) = {"
no
no
Oj
no
no
xW
xW
xW
xW
xW
xW
xW
xW
xW
xW
no
no
"}
(24,1,1) = {"
no
no
Oj
Oj
no
xW
no
no
xW
no
no
xW
no
no
xW
no
no
"}
(25,1,1) = {"
no
no
no
Oj
Oj
Oj
Oj
Oj
Oj
Oj
Oj
Oj
Oj
Oj
Oj
Oj
no
"}
(26,1,1) = {"
no
no
no
no
no
xW
no
no
xW
no
no
xW
no
no
xW
no
no
"}
(27,1,1) = {"
no
no
no
no
no
nd
no
no
nd
no
no
nd
no
no
nd
no
no
"}
