//MAP CONVERTED BY dmm2tgm.py THIS HEADER COMMENT PREVENTS RECONVERSION, DO NOT REMOVE
"a" = (
/obj/machinery/computer/communications,
/obj/machinery/keycard_auth{
	pixel_x = 7;
	pixel_y = 25
	},
/obj/effect/turf_decal/bot,
/obj/structure/phone_base/captain{
	pixel_x = -7;
	pixel_y = 29
	},
/turf/open/floor/carpet/royalblue,
/area/station/command/heads_quarters/captain)

(1,1,1) = {"
a
"}
