//MAP CONVERTED BY dmm2tgm.py THIS HEADER COMMENT PREVENTS RECONVERSION, DO NOT REMOVE
"a" = (
/obj/effect/turf_decal/trimline/blue/filled/warning{
	dir = 6
	},
/obj/machinery/airalarm/directional/east,
/obj/effect/mapping_helpers/airalarm/tlv_cold_room,
/turf/open/floor/iron/kitchen_coldroom/freezerfloor,
/area/station/medical/coldroom)
"b" = (
/obj/structure/fans/tiny,
/obj/machinery/door/airlock/maintenance{
	critical_machine = 1;
	name = "Cold Room Maintenance"
	},
/obj/effect/mapping_helpers/airlock/access/all/medical/surgery,
/turf/open/floor/iron/kitchen_coldroom/freezerfloor,
/area/station/maintenance/department/medical/central)
"h" = (
/obj/machinery/atmospherics/pipe/smart/manifold4w/supply/hidden/layer4,
/obj/structure/cable,
/obj/machinery/atmospherics/pipe/smart/manifold4w/scrubbers/hidden/layer2,
/obj/effect/turf_decal/trimline/blue/filled/warning{
	dir = 1
	},
/turf/open/floor/iron/kitchen_coldroom/freezerfloor,
/area/station/medical/coldroom)
"q" = (
/obj/effect/turf_decal/bot,
/obj/structure/rack,
/obj/effect/turf_decal/trimline/blue/filled/line{
	dir = 9
	},
/obj/structure/extinguisher_cabinet/directional/west,
/turf/open/floor/iron/kitchen_coldroom/freezerfloor,
/area/station/medical/coldroom)
"t" = (
/obj/effect/turf_decal/trimline/blue/filled/line{
	dir = 1
	},
/turf/open/floor/iron/kitchen_coldroom/freezerfloor,
/area/station/medical/coldroom)
"v" = (
/obj/machinery/atmospherics/components/unary/vent_pump/on/layer4{
	dir = 1
	},
/obj/effect/turf_decal/trimline/blue/filled/line{
	dir = 4
	},
/obj/structure/sign/warning/chem_diamond/directional/east,
/obj/machinery/camera/directional/east{
	c_tag = "Medbay - Freezer";
	name = "medbay camera";
	network = list("ss13","medbay")
	},
/turf/open/floor/iron/kitchen_coldroom/freezerfloor,
/area/station/medical/coldroom)
"z" = (
/obj/effect/turf_decal/box/white{
	color = "#52B4E9"
	},
/obj/effect/turf_decal/trimline/blue/filled/line,
/obj/machinery/light/cold/directional/south,
/obj/machinery/portable_atmospherics/canister/anesthetic_mix,
/turf/open/floor/iron/kitchen_coldroom/freezerfloor,
/area/station/medical/coldroom)
"A" = (
/obj/effect/turf_decal/bot,
/obj/structure/closet/crate/freezer/blood,
/obj/effect/turf_decal/trimline/blue/filled/line{
	dir = 8
	},
/obj/item/radio/intercom/directional/west,
/turf/open/floor/iron/kitchen_coldroom/freezerfloor,
/area/station/medical/coldroom)
"B" = (
/obj/machinery/atmospherics/components/unary/vent_scrubber/on/layer2{
	dir = 4
	},
/turf/open/floor/iron/kitchen_coldroom/freezerfloor,
/area/station/medical/coldroom)
"E" = (
/obj/effect/turf_decal/bot,
/obj/machinery/atmospherics/pipe/smart/manifold4w/supply/hidden/layer4,
/obj/effect/turf_decal/trimline/blue/filled/line{
	dir = 5
	},
/obj/machinery/power/apc/auto_name/directional/north,
/obj/structure/cable,
/obj/structure/closet/crate/freezer/surplus_limbs,
/obj/machinery/light_switch/directional/east,
/turf/open/floor/iron/kitchen_coldroom/freezerfloor,
/area/station/medical/coldroom)
"F" = (
/obj/effect/turf_decal/trimline/blue/filled/line{
	dir = 10
	},
/obj/structure/closet/crate/internals,
/obj/effect/turf_decal/bot,
/obj/item/tank/internals/emergency_oxygen,
/obj/item/tank/internals/emergency_oxygen,
/obj/item/tank/internals/nitrogen/belt,
/obj/item/tank/internals/nitrogen/belt,
/obj/item/clothing/mask/breath/vox,
/obj/item/clothing/mask/breath/vox,
/obj/item/clothing/mask/breath/vox,
/obj/item/clothing/mask/breath/vox,
/turf/open/floor/iron/kitchen_coldroom/freezerfloor,
/area/station/medical/coldroom)
"G" = (
/turf/template_noop,
/area/template_noop)
"J" = (
/obj/effect/turf_decal/box/white{
	color = "#52B4E9"
	},
/obj/effect/turf_decal/trimline/blue/filled/line,
/obj/machinery/portable_atmospherics/canister/anesthetic_mix,
/obj/structure/sign/poster/official/science/directional/south,
/turf/open/floor/iron/kitchen_coldroom/freezerfloor,
/area/station/medical/coldroom)
"Q" = (
/turf/open/floor/plating,
/area/station/maintenance/department/medical/central)
"T" = (
/obj/machinery/atmospherics/pipe/smart/manifold4w/scrubbers/hidden/layer2,
/obj/effect/landmark/event_spawn,
/turf/open/floor/iron/kitchen_coldroom/freezerfloor,
/area/station/medical/coldroom)
"U" = (
/obj/machinery/atmospherics/pipe/smart/manifold4w/supply/hidden/layer4,
/obj/structure/cable,
/obj/machinery/atmospherics/pipe/smart/manifold4w/scrubbers/hidden/layer2,
/obj/structure/fans/tiny,
/obj/machinery/door/airlock/freezer{
	critical_machine = 1;
	name = "Medical Freezer"
	},
/obj/effect/mapping_helpers/airlock/access/all/medical/surgery,
/turf/open/floor/iron/kitchen_coldroom/freezerfloor,
/area/station/medical/coldroom)
"X" = (
/obj/structure/cable,
/obj/machinery/atmospherics/pipe/smart/manifold4w/supply/hidden/layer4,
/obj/machinery/atmospherics/pipe/smart/manifold4w/scrubbers/hidden/layer2,
/turf/open/floor/plating,
/area/station/maintenance/department/medical/central)

(1,1,1) = {"
G
q
A
F
G
G
G
"}
(2,1,1) = {"
G
t
B
J
G
G
Q
"}
(3,1,1) = {"
U
h
T
z
G
X
Q
"}
(4,1,1) = {"
G
E
v
a
b
X
G
"}
