//MAP CONVERTED BY dmm2tgm.py THIS HEADER COMMENT PREVENTS RECONVERSION, DO NOT REMOVE
"a" = (
/turf/template_noop,
/area/template_noop)
"e" = (
/obj/machinery/atmospherics/components/unary/vent_pump/on/layer4,
/obj/effect/turf_decal/trimline/purple/filled/warning{
	dir = 1
	},
/obj/structure/disposalpipe/segment{
	dir = 10
	},
/obj/machinery/atmospherics/pipe/smart/manifold4w/scrubbers/hidden/layer2,
/turf/open/floor/iron/white/smooth_edge,
/area/station/science/explab)
"f" = (
/turf/open/floor/engine,
/area/station/science/explab)
"m" = (
/obj/structure/table/reinforced,
/obj/effect/mob_spawn/ghost_role/borer_egg,
/obj/effect/mob_spawn/ghost_role/borer_egg,
/obj/effect/mob_spawn/ghost_role/borer_egg,
/turf/open/floor/engine,
/area/station/science/explab)
"s" = (
/obj/effect/turf_decal/trimline/purple/filled/line{
	dir = 9
	},
/obj/machinery/disposal/bin,
/obj/structure/disposalpipe/trunk{
	dir = 4
	},
/obj/effect/turf_decal/box,
/obj/item/radio/intercom/directional/west,
/obj/machinery/atmospherics/pipe/smart/manifold4w/supply/hidden/layer4,
/turf/open/floor/iron/white,
/area/station/science/explab)
"C" = (
/obj/machinery/door/window/left/directional/south{
	name = "Research Test Chamber";
	req_access = list("science")
	},
/turf/open/floor/engine,
/area/station/science/explab)
"E" = (
/obj/structure/window/reinforced/spawner/directional/south,
/obj/machinery/atmospherics/components/unary/vent_pump/on/layer4,
/turf/open/floor/engine,
/area/station/science/explab)
"J" = (
/obj/structure/cable,
/obj/machinery/atmospherics/pipe/smart/manifold4w/scrubbers/hidden/layer2,
/obj/machinery/atmospherics/pipe/smart/manifold4w/supply/hidden/layer4,
/obj/effect/turf_decal/trimline/purple/filled/warning,
/obj/structure/disposalpipe/segment,
/obj/machinery/holopad,
/obj/effect/turf_decal/bot,
/turf/open/floor/iron/white/smooth_edge{
	dir = 1
	},
/area/station/science/explab)
"X" = (
/obj/structure/table,
/obj/structure/cable,
/obj/machinery/power/apc/auto_name/directional/west,
/obj/effect/turf_decal/trimline/purple/filled/line{
	dir = 10
	},
/obj/item/relic,
/obj/machinery/firealarm/directional/west{
	pixel_y = 17
	},
/obj/item/taperecorder{
	pixel_x = -5;
	pixel_y = 4
	},
/obj/machinery/atmospherics/pipe/smart/manifold4w/supply/hidden/layer4,
/turf/open/floor/iron/white,
/area/station/science/explab)

(1,1,1) = {"
a
a
m
E
s
X
"}
(2,1,1) = {"
a
a
f
C
e
J
"}
(3,1,1) = {"
a
a
a
a
a
a
"}
(4,1,1) = {"
a
a
a
a
a
a
"}
