//MAP CONVERTED BY dmm2tgm.py THIS HEADER COMMENT PREVENTS RECONVERSION, DO NOT REMOVE
"a" = (
/turf/template_noop,
/area/template_noop)
"b" = (
/obj/structure/cable,
/obj/structure/chair/stool/directional/west,
/obj/machinery/atmospherics/pipe/smart/manifold4w/scrubbers/hidden/layer2,
/obj/structure/disposalpipe/segment{
	dir = 6
	},
/obj/effect/landmark/start/explorer,
/turf/open/floor/iron/dark/smooth_large,
/area/station/command/gateway)
"h" = (
/obj/machinery/light_switch/directional/west,
/obj/machinery/atmospherics/components/unary/vent_pump/on/layer4{
	dir = 4
	},
/obj/effect/turf_decal/trimline/blue/filled/warning{
	dir = 10
	},
/obj/effect/landmark/start/explorer,
/turf/open/floor/iron/dark,
/area/station/command/gateway)
"r" = (
/obj/structure/cable,
/obj/machinery/atmospherics/pipe/smart/manifold4w/scrubbers/hidden/layer2,
/obj/structure/disposalpipe/segment,
/obj/machinery/holopad,
/obj/effect/turf_decal/bot,
/obj/effect/landmark/start/explorer,
/turf/open/floor/iron/dark/smooth_large,
/area/station/command/gateway)

(1,1,1) = {"
a
a
a
h
"}
(2,1,1) = {"
b
a
r
a
"}
