//MAP CONVERTED BY dmm2tgm.py THIS HEADER COMMENT PREVENTS RECONVERSION, DO NOT REMOVE
"a" = (
/obj/structure/table,
/obj/machinery/light/directional/east,
/obj/effect/turf_decal/tile/blue/half/contrasted{
	dir = 4
	},
/obj/effect/turf_decal/tile/neutral{
	dir = 4
	},
/obj/machinery/fax{
	fax_name = "Bridge";
	name = "Bridge Fax Machine"
	},
/turf/open/floor/iron,
/area/station/command/bridge)
"r" = (
/obj/structure/table,
/obj/machinery/recharger{
	pixel_x = 6;
	pixel_y = 0
	},
/obj/machinery/status_display/ai/directional/east,
/obj/machinery/camera/directional/east{
	c_tag = "Bridge Starboard";
	name = "command camera"
	},
/obj/effect/turf_decal/tile/blue/half/contrasted{
	dir = 4
	},
/obj/effect/turf_decal/tile/neutral{
	dir = 4
	},
/obj/machinery/recharger{
	pixel_x = -6;
	pixel_y = 0
	},
/turf/open/floor/iron,
/area/station/command/bridge)

(1,1,1) = {"
a
r
"}
