//MAP CONVERTED BY dmm2tgm.py THIS HEADER COMMENT PREVENTS RECONVERSION, DO NOT REMOVE
"a" = (
/obj/effect/decal/cleanable/generic,
/obj/effect/decal/cleanable/dirt,
/obj/structure/sign/poster/contraband/power/directional/east,
/obj/effect/cult_turf,
/turf/open/floor/plating,
/area/space)
"c" = (
/obj/effect/decal/cleanable/insectguts,
/obj/structure/sign/poster/contraband/random/directional/east,
/turf/open/floor/plating,
/area/space)
"d" = (
/obj/effect/decal/cleanable/plasma,
/obj/effect/cult_turf,
/turf/open/floor/iron,
/area/space)
"f" = (
/obj/effect/mapping_helpers/burnt_floor,
/obj/machinery/atmospherics/components/unary/vent_pump/on/layer4{
	dir = 8
	},
/turf/open/floor/plating,
/area/space)
"g" = (
/obj/effect/decal/cleanable/ash,
/obj/effect/cult_turf,
/turf/open/floor/plating,
/area/space)
"h" = (
/obj/structure/table_frame/wood,
/turf/open/floor/plating,
/area/space)
"i" = (
/obj/effect/decal/cleanable/dirt,
/obj/structure/fluff/broken_canister_frame,
/turf/open/floor/plating,
/area/space)
"j" = (
/obj/structure/lattice/catwalk,
/obj/structure/marker_beacon/bronze,
/turf/open/space/basic,
/area/space)
"l" = (
/obj/structure/closet/cabinet,
/obj/effect/spawner/random/maintenance,
/turf/open/floor/plating,
/area/space)
"s" = (
/turf/open/floor/plating,
/area/space)
"x" = (
/obj/effect/mapping_helpers/broken_floor,
/obj/effect/cult_turf,
/turf/open/floor/iron,
/area/space)
"z" = (
/obj/effect/mapping_helpers/burnt_floor,
/obj/effect/cult_turf,
/obj/effect/spawner/random/trash/graffiti,
/obj/structure/chair/wood/wings{
	dir = 8
	},
/turf/open/floor/iron,
/area/space)
"B" = (
/obj/effect/decal/cleanable/dirt,
/obj/effect/cult_turf,
/turf/open/floor/iron,
/area/space)
"D" = (
/obj/structure/sign/poster/contraband/random/directional/north,
/turf/open/floor/plating,
/area/space)
"E" = (
/obj/effect/decal/cleanable/plasma,
/obj/effect/mapping_helpers/broken_floor,
/obj/effect/cult_turf,
/obj/effect/landmark/blobstart,
/turf/open/floor/iron,
/area/space)
"G" = (
/obj/effect/mapping_helpers/burnt_floor,
/obj/effect/landmark/generic_maintenance_landmark,
/turf/open/floor/plating,
/area/space)
"J" = (
/obj/effect/decal/cleanable/plasma,
/obj/item/chair/wood/wings,
/obj/effect/cult_turf,
/turf/open/floor/plating,
/area/space)
"L" = (
/obj/effect/mapping_helpers/burnt_floor,
/obj/structure/table/wood,
/obj/item/reagent_containers/cup/glass/trophy{
	pixel_x = 5;
	pixel_y = 10
	},
/obj/item/toy/eldritch_book{
	pixel_x = -8
	},
/obj/effect/cult_turf,
/turf/open/floor/iron,
/area/space)
"M" = (
/obj/effect/mapping_helpers/broken_floor,
/obj/structure/table_frame/wood,
/turf/open/floor/plating,
/area/space)
"N" = (
/obj/structure/reagent_dispensers/watertank,
/turf/open/floor/plating,
/area/space)
"Q" = (
/obj/effect/mapping_helpers/broken_floor,
/obj/structure/table/wood,
/obj/item/clothing/glasses/blindfold{
	pixel_x = 2;
	pixel_y = -3
	},
/obj/effect/cult_turf,
/turf/open/floor/iron,
/area/space)
"R" = (
/obj/structure/lattice,
/turf/open/space/basic,
/area/space)
"T" = (
/turf/closed/wall,
/area/space)
"V" = (
/obj/effect/mapping_helpers/burnt_floor,
/obj/effect/spawner/random/trash/graffiti,
/turf/open/floor/plating,
/area/space)
"W" = (
/obj/item/reagent_containers/cup/glass/trophy{
	pixel_x = -9;
	pixel_y = 6
	},
/turf/open/floor/plating,
/area/space)
"X" = (
/turf/open/space/basic,
/area/space)
"Z" = (
/obj/effect/mapping_helpers/burnt_floor,
/obj/effect/decal/cleanable/dirt,
/obj/item/flashlight/lantern{
	start_on = 1
	},
/obj/machinery/light/broken/directional/east,
/turf/open/floor/iron,
/area/space)

(1,1,1) = {"
T
D
B
x
h
M
f
G
s
g
Q
"}
(2,1,1) = {"
T
N
d
Z
W
E
V
i
c
z
L
"}
(3,1,1) = {"
T
T
T
T
a
J
l
T
T
T
T
"}
(4,1,1) = {"
T
X
X
T
T
T
T
T
X
X
X
"}
(5,1,1) = {"
T
R
X
X
X
X
X
X
X
X
X
"}
(6,1,1) = {"
T
j
X
X
X
X
X
X
X
X
X
"}
(7,1,1) = {"
T
R
X
X
X
X
X
X
X
X
X
"}
(8,1,1) = {"
T
X
X
X
X
X
X
X
X
X
X
"}
(9,1,1) = {"
T
X
X
X
X
X
X
X
X
X
X
"}
(10,1,1) = {"
T
R
X
X
X
X
X
X
X
X
X
"}
(11,1,1) = {"
T
R
X
X
X
X
X
X
X
X
X
"}
