//MAP CONVERTED BY dmm2tgm.py THIS HEADER COMMENT PREVENTS RECONVERSION, DO NOT REMOVE
"a" = (
/turf/open/space/basic,
/area/space)
"c" = (
/obj/machinery/light/directional/south,
/obj/item/kirbyplants/random,
/turf/open/floor/iron/dark,
/area/station/cargo/exploration_office)
"d" = (
/obj/machinery/power/apc/auto_name/directional/north,
/turf/open/floor/iron/dark,
/area/station/cargo/exploration_office)
"f" = (
/obj/machinery/dive_anchor/stationary,
/obj/effect/turf_decal/stripes/box,
/turf/open/floor/engine,
/area/station/cargo/exploration_office)
"g" = (
/obj/structure/closet/crate/bin,
/turf/open/floor/iron/dark,
/area/station/cargo/exploration_office)
"i" = (
/obj/effect/mapping_helpers/broken_floor,
/obj/effect/cult_turf,
/obj/structure/cable,
/obj/machinery/atmospherics/pipe/smart/manifold4w/supply/hidden/layer4,
/obj/machinery/atmospherics/pipe/smart/manifold4w/scrubbers/hidden/layer2,
/turf/open/floor/iron,
/area/station/maintenance/fore/lesser)
"j" = (
/obj/structure/rack,
/obj/item/stack/rods/twentyfive,
/obj/item/multitool,
/obj/item/stack/impure_telecrystal,
/obj/machinery/camera/autoname/directional/east,
/obj/structure/sign/warning/vacuum/external/directional/east,
/turf/open/floor/iron/dark,
/area/station/cargo/exploration_office)
"l" = (
/obj/effect/turf_decal/stripes/line{
	dir = 5
	},
/turf/open/floor/engine,
/area/station/cargo/exploration_office)
"m" = (
/obj/structure/lattice/catwalk,
/obj/structure/sign/warning/directional/north,
/turf/open/space/basic,
/area/space/nearstation)
"n" = (
/obj/effect/turf_decal/stripes/line{
	dir = 4
	},
/turf/open/floor/engine,
/area/station/cargo/exploration_office)
"o" = (
/obj/effect/turf_decal/stripes/line{
	dir = 9
	},
/obj/structure/sign/poster/abductor/ayylian/directional/west,
/turf/open/floor/engine,
/area/station/cargo/exploration_office)
"p" = (
/turf/template_noop,
/area/template_noop)
"q" = (
/obj/effect/turf_decal/stripes/line{
	dir = 10
	},
/obj/structure/sign/poster/official/safety_internals/directional/west,
/turf/open/floor/engine,
/area/station/cargo/exploration_office)
"r" = (
/obj/effect/landmark/navigate_destination/exploration_office,
/obj/machinery/door/airlock/mining{
	name = "Exploration Office"
	},
/obj/machinery/door/firedoor,
/obj/effect/mapping_helpers/airlock/access/any/command/gateway,
/obj/machinery/atmospherics/pipe/smart/manifold4w/supply/hidden/layer4,
/obj/machinery/atmospherics/pipe/smart/manifold4w/scrubbers/hidden/layer2,
/obj/structure/cable,
/turf/open/floor/iron/dark,
/area/station/cargo/exploration_office)
"s" = (
/turf/closed/wall,
/area/station/cargo/exploration_office)
"v" = (
/turf/open/floor/iron/dark,
/area/station/cargo/exploration_office)
"w" = (
/obj/machinery/suit_storage_unit/standard_unit,
/turf/open/floor/iron/dark,
/area/station/cargo/exploration_office)
"x" = (
/obj/machinery/computer/anchor_controller{
	dir = 1
	},
/turf/open/floor/iron/dark,
/area/station/cargo/exploration_office)
"y" = (
/obj/effect/turf_decal/stripes/line{
	dir = 1
	},
/obj/machinery/door/airlock/external{
	name = "Exploration Office Airlock";
	space_dir = 1
	},
/obj/effect/mapping_helpers/airlock/cyclelink_helper_multi{
	cycle_id = "exploration-office-airlock"
	},
/obj/effect/mapping_helpers/airlock/access/all/command/gateway,
/turf/open/floor/iron/dark,
/area/station/cargo/exploration_office)
"z" = (
/obj/structure/lattice/catwalk,
/turf/open/space/basic,
/area/space/nearstation)
"A" = (
/obj/effect/turf_decal/stripes/line{
	dir = 6
	},
/turf/open/floor/engine,
/area/station/cargo/exploration_office)
"B" = (
/obj/effect/turf_decal/stripes/line{
	dir = 8
	},
/obj/machinery/door/airlock/external{
	name = "Exploration Office Airlock";
	space_dir = 1
	},
/obj/effect/mapping_helpers/airlock/cyclelink_helper_multi{
	cycle_id = "exploration-office-airlock"
	},
/obj/effect/mapping_helpers/airlock/access/all/command/gateway,
/turf/open/floor/iron/dark,
/area/station/cargo/exploration_office)
"C" = (
/obj/structure/chair/office,
/obj/effect/landmark/start/explorer,
/turf/open/floor/iron/dark,
/area/station/cargo/exploration_office)
"D" = (
/obj/structure/extinguisher_cabinet/directional/east,
/obj/effect/landmark/start/explorer,
/turf/open/floor/iron/dark,
/area/station/cargo/exploration_office)
"E" = (
/obj/effect/landmark/start/explorer,
/turf/open/floor/iron/dark,
/area/station/cargo/exploration_office)
"F" = (
/obj/effect/turf_decal/stripes/line,
/turf/open/floor/engine,
/area/station/cargo/exploration_office)
"G" = (
/obj/structure/tank_dispenser/oxygen,
/obj/machinery/camera/autoname/directional/west,
/turf/open/floor/iron/dark,
/area/station/cargo/exploration_office)
"H" = (
/obj/machinery/light/directional/north,
/turf/open/floor/iron/dark,
/area/station/cargo/exploration_office)
"I" = (
/obj/structure/table,
/obj/item/paper_bin{
	pixel_y = 4
	},
/obj/item/radio,
/obj/item/flashlight,
/turf/open/floor/iron/dark,
/area/station/cargo/exploration_office)
"J" = (
/obj/effect/decal/cleanable/dirt,
/obj/effect/cult_turf,
/obj/structure/cable,
/obj/machinery/atmospherics/pipe/smart/manifold4w/supply/hidden/layer4,
/obj/machinery/atmospherics/pipe/smart/manifold4w/scrubbers/hidden/layer2,
/turf/open/floor/iron,
/area/station/maintenance/fore/lesser)
"K" = (
/obj/machinery/light_switch/directional/south,
/turf/open/floor/iron/dark,
/area/station/cargo/exploration_office)
"N" = (
/obj/machinery/firealarm/directional/east,
/turf/open/floor/iron/dark,
/area/station/cargo/exploration_office)
"P" = (
/obj/machinery/airalarm/directional/north,
/turf/open/floor/iron/dark,
/area/station/cargo/exploration_office)
"Q" = (
/obj/structure/lattice,
/turf/template_noop,
/area/template_noop)
"R" = (
/obj/effect/turf_decal/stripes/line{
	dir = 1
	},
/turf/open/floor/engine,
/area/station/cargo/exploration_office)
"S" = (
/obj/machinery/light/small/directional/south,
/turf/open/floor/iron/dark,
/area/station/cargo/exploration_office)
"T" = (
/obj/structure/lattice,
/turf/template_noop,
/area/space/nearstation)
"U" = (
/obj/structure/bed/dogbed{
	name = "Lem's bed";
	desc = "A comfy-looking cat bed. You can even strap your pet in, in case the gravity turns off."
	},
/mob/living/basic/pet/cat/space{
	name = "Lem";
	gender = "male";
	unique_pet = 1;
	desc = "He's kittened out for space exploration."
	},
/turf/open/floor/iron/dark,
/area/station/cargo/exploration_office)
"V" = (
/obj/machinery/dive_anchor/debug,
/turf/open/space/basic,
/area/space/nearstation)
"X" = (
/obj/effect/turf_decal/stripes/line{
	dir = 8
	},
/obj/machinery/light/directional/west,
/turf/open/floor/engine,
/area/station/cargo/exploration_office)
"Y" = (
/obj/effect/spawner/structure/window/reinforced,
/turf/open/floor/plating,
/area/station/cargo/exploration_office)
"Z" = (
/obj/effect/decal/cleanable/plasma,
/obj/effect/cult_turf,
/obj/structure/cable,
/obj/machinery/atmospherics/pipe/smart/manifold4w/supply/hidden/layer4,
/obj/machinery/atmospherics/pipe/smart/manifold4w/scrubbers/hidden/layer2,
/turf/open/floor/iron,
/area/station/maintenance/fore/lesser)

(1,1,1) = {"
p
p
J
i
p
p
p
p
p
p
p
"}
(2,1,1) = {"
p
p
Z
p
p
p
p
p
p
p
p
"}
(3,1,1) = {"
p
p
r
p
p
p
p
p
p
p
p
"}
(4,1,1) = {"
p
G
K
p
p
p
p
p
C
x
s
"}
(5,1,1) = {"
p
d
v
v
o
X
q
g
v
I
s
"}
(6,1,1) = {"
p
H
E
v
R
f
F
v
v
c
s
"}
(7,1,1) = {"
p
P
v
N
l
n
A
D
v
U
s
"}
(8,1,1) = {"
p
w
w
s
Y
Y
Y
s
v
j
s
"}
(9,1,1) = {"
p
s
s
s
m
z
z
s
B
s
s
"}
(10,1,1) = {"
p
Q
T
T
z
V
z
y
S
s
a
"}
(11,1,1) = {"
p
Q
p
p
z
z
z
s
Y
s
a
"}
