//MAP CONVERTED BY dmm2tgm.py THIS HEADER COMMENT PREVENTS RECONVERSION, DO NOT REMOVE
"a" = (
/obj/structure/lattice/catwalk,
/turf/open/space/basic,
/area/space/nearstation)
"c" = (
/obj/effect/turf_decal/stripes/line{
	dir = 1
	},
/obj/machinery/door/airlock/external{
	name = "Exploration Office Airlock";
	space_dir = 1
	},
/obj/effect/mapping_helpers/airlock/cyclelink_helper_multi{
	cycle_id = "exploration-office-airlock"
	},
/obj/effect/mapping_helpers/airlock/access/all/command/gateway,
/turf/open/floor/iron/dark,
/area/station/cargo/exploration_office)
"d" = (
/obj/machinery/firealarm/directional/east,
/turf/open/floor/iron/dark,
/area/station/cargo/exploration_office)
"e" = (
/obj/machinery/dive_anchor/stationary,
/obj/effect/turf_decal/stripes/box,
/turf/open/floor/engine,
/area/station/cargo/exploration_office)
"f" = (
/obj/effect/landmark/start/explorer,
/obj/machinery/atmospherics/components/unary/vent_scrubber/on/layer2{
	dir = 8
	},
/turf/open/floor/iron/dark,
/area/station/cargo/exploration_office)
"h" = (
/obj/structure/table,
/obj/item/paper_bin{
	pixel_y = 4
	},
/obj/item/radio,
/obj/item/flashlight,
/turf/open/floor/iron/dark,
/area/station/cargo/exploration_office)
"i" = (
/obj/effect/decal/cleanable/plasma,
/obj/effect/cult_turf,
/obj/structure/cable,
/obj/machinery/atmospherics/pipe/smart/manifold4w/supply/hidden/layer4,
/obj/machinery/atmospherics/pipe/smart/manifold4w/scrubbers/hidden/layer2,
/turf/open/floor/iron,
/area/station/maintenance/fore/lesser)
"j" = (
/obj/machinery/light/small/directional/south,
/turf/open/floor/iron/dark,
/area/station/cargo/exploration_office)
"k" = (
/obj/effect/turf_decal/stripes/line{
	dir = 8
	},
/obj/machinery/light/directional/west,
/obj/machinery/atmospherics/pipe/smart/manifold4w/supply/hidden/layer4,
/turf/open/floor/engine,
/area/station/cargo/exploration_office)
"m" = (
/obj/structure/closet/crate/bin,
/obj/machinery/atmospherics/pipe/smart/manifold4w/supply/hidden/layer4,
/turf/open/floor/iron/dark,
/area/station/cargo/exploration_office)
"n" = (
/obj/machinery/suit_storage_unit/standard_unit,
/turf/open/floor/iron/dark,
/area/station/cargo/exploration_office)
"o" = (
/obj/structure/bed/dogbed{
	name = "Lem's bed";
	desc = "A comfy-looking cat bed. You can even strap your pet in, in case the gravity turns off."
	},
/mob/living/basic/pet/cat/space{
	name = "Lem";
	gender = "male";
	unique_pet = 1;
	desc = "He's kittened out for space exploration."
	},
/turf/open/floor/iron/dark,
/area/station/cargo/exploration_office)
"q" = (
/obj/structure/rack,
/obj/item/stack/rods/twentyfive,
/obj/item/multitool,
/obj/item/stack/impure_telecrystal,
/obj/machinery/camera/autoname/directional/east,
/obj/structure/sign/warning/vacuum/external/directional/east,
/turf/open/floor/iron/dark,
/area/station/cargo/exploration_office)
"r" = (
/turf/template_noop,
/area/template_noop)
"s" = (
/obj/structure/cable,
/obj/machinery/atmospherics/pipe/smart/manifold4w/supply/hidden/layer4,
/obj/machinery/atmospherics/pipe/smart/manifold4w/scrubbers/hidden/layer2,
/turf/open/floor/iron/dark,
/area/station/cargo/exploration_office)
"t" = (
/obj/effect/mapping_helpers/broken_floor,
/obj/effect/cult_turf,
/obj/structure/cable,
/obj/machinery/atmospherics/pipe/smart/manifold4w/supply/hidden/layer4,
/obj/machinery/atmospherics/pipe/smart/manifold4w/scrubbers/hidden/layer2,
/turf/open/floor/iron,
/area/station/maintenance/fore/lesser)
"u" = (
/obj/machinery/atmospherics/components/unary/vent_pump/on/layer4{
	dir = 8
	},
/turf/open/floor/iron/dark,
/area/station/cargo/exploration_office)
"v" = (
/obj/effect/turf_decal/stripes/line,
/turf/open/floor/engine,
/area/station/cargo/exploration_office)
"w" = (
/obj/effect/spawner/structure/window/reinforced,
/turf/open/floor/plating,
/area/station/cargo/exploration_office)
"x" = (
/obj/effect/turf_decal/stripes/line{
	dir = 8
	},
/obj/machinery/door/airlock/external{
	name = "Exploration Office Airlock";
	space_dir = 1
	},
/obj/effect/mapping_helpers/airlock/cyclelink_helper_multi{
	cycle_id = "exploration-office-airlock"
	},
/obj/effect/mapping_helpers/airlock/access/all/command/gateway,
/turf/open/floor/iron/dark,
/area/station/cargo/exploration_office)
"y" = (
/obj/effect/turf_decal/stripes/line{
	dir = 9
	},
/obj/structure/sign/poster/abductor/ayylian/directional/west,
/obj/machinery/atmospherics/pipe/smart/manifold4w/supply/hidden/layer4,
/turf/open/floor/engine,
/area/station/cargo/exploration_office)
"A" = (
/obj/structure/chair/office,
/obj/effect/landmark/start/explorer,
/turf/open/floor/iron/dark,
/area/station/cargo/exploration_office)
"B" = (
/obj/effect/turf_decal/stripes/line{
	dir = 4
	},
/turf/open/floor/engine,
/area/station/cargo/exploration_office)
"C" = (
/obj/machinery/computer/anchor_controller{
	dir = 1
	},
/turf/open/floor/iron/dark,
/area/station/cargo/exploration_office)
"E" = (
/obj/effect/turf_decal/stripes/line{
	dir = 1
	},
/turf/open/floor/engine,
/area/station/cargo/exploration_office)
"G" = (
/obj/machinery/light/directional/south,
/obj/item/kirbyplants/random,
/turf/open/floor/iron/dark,
/area/station/cargo/exploration_office)
"H" = (
/obj/machinery/airalarm/directional/north,
/turf/open/floor/iron/dark,
/area/station/cargo/exploration_office)
"I" = (
/obj/structure/lattice,
/turf/template_noop,
/area/space/nearstation)
"K" = (
/obj/machinery/power/apc/auto_name/directional/north,
/obj/structure/cable,
/turf/open/floor/iron/dark,
/area/station/cargo/exploration_office)
"L" = (
/obj/machinery/dive_anchor/debug,
/turf/open/space/basic,
/area/space/nearstation)
"M" = (
/obj/effect/turf_decal/stripes/line{
	dir = 6
	},
/turf/open/floor/engine,
/area/station/cargo/exploration_office)
"N" = (
/obj/effect/decal/cleanable/dirt,
/obj/effect/cult_turf,
/obj/structure/cable,
/obj/machinery/atmospherics/pipe/smart/manifold4w/supply/hidden/layer4,
/obj/machinery/atmospherics/pipe/smart/manifold4w/scrubbers/hidden/layer2,
/turf/open/floor/iron,
/area/station/maintenance/fore/lesser)
"O" = (
/turf/open/floor/iron/dark,
/area/station/cargo/exploration_office)
"P" = (
/obj/structure/extinguisher_cabinet/directional/east,
/obj/effect/landmark/start/explorer,
/turf/open/floor/iron/dark,
/area/station/cargo/exploration_office)
"Q" = (
/obj/effect/turf_decal/stripes/line{
	dir = 5
	},
/turf/open/floor/engine,
/area/station/cargo/exploration_office)
"R" = (
/obj/machinery/light_switch/directional/south,
/obj/structure/cable,
/obj/machinery/atmospherics/pipe/smart/manifold4w/supply/hidden/layer4,
/obj/machinery/atmospherics/pipe/smart/manifold4w/scrubbers/hidden/layer2,
/turf/open/floor/iron/dark,
/area/station/cargo/exploration_office)
"S" = (
/obj/machinery/atmospherics/pipe/smart/manifold4w/supply/hidden/layer4,
/turf/open/floor/iron/dark,
/area/station/cargo/exploration_office)
"T" = (
/obj/machinery/light/directional/north,
/turf/open/floor/iron/dark,
/area/station/cargo/exploration_office)
"U" = (
/obj/effect/landmark/navigate_destination/exploration_office,
/obj/machinery/door/airlock/mining{
	name = "Exploration Office"
	},
/obj/machinery/door/firedoor,
/obj/effect/mapping_helpers/airlock/access/any/command/gateway,
/obj/machinery/atmospherics/pipe/smart/manifold4w/supply/hidden/layer4,
/obj/machinery/atmospherics/pipe/smart/manifold4w/scrubbers/hidden/layer2,
/obj/structure/cable,
/turf/open/floor/iron/dark,
/area/station/cargo/exploration_office)
"V" = (
/turf/closed/wall,
/area/station/cargo/exploration_office)
"W" = (
/obj/structure/lattice/catwalk,
/obj/structure/sign/warning/directional/north,
/turf/open/space/basic,
/area/space/nearstation)
"X" = (
/obj/effect/turf_decal/stripes/line{
	dir = 10
	},
/obj/structure/sign/poster/official/safety_internals/directional/west,
/obj/machinery/atmospherics/pipe/smart/manifold4w/supply/hidden/layer4,
/turf/open/floor/engine,
/area/station/cargo/exploration_office)
"Y" = (
/obj/structure/tank_dispenser/oxygen,
/obj/machinery/camera/autoname/directional/west,
/turf/open/floor/iron/dark,
/area/station/cargo/exploration_office)

(1,1,1) = {"
r
r
N
t
r
r
r
r
r
r
r
"}
(2,1,1) = {"
r
r
i
r
r
r
r
r
r
r
r
"}
(3,1,1) = {"
r
r
U
r
r
r
r
r
r
r
r
"}
(4,1,1) = {"
r
Y
R
r
r
r
r
r
A
C
V
"}
(5,1,1) = {"
r
K
s
S
y
k
X
m
S
h
V
"}
(6,1,1) = {"
r
T
f
O
E
e
v
O
u
G
V
"}
(7,1,1) = {"
r
H
O
d
Q
B
M
P
O
o
V
"}
(8,1,1) = {"
r
n
n
V
w
w
w
V
O
q
V
"}
(9,1,1) = {"
r
V
V
V
W
a
a
V
x
V
V
"}
(10,1,1) = {"
r
r
I
I
a
L
a
c
j
V
r
"}
(11,1,1) = {"
r
r
r
r
a
a
a
V
w
V
r
"}
