//MAP CONVERTED BY dmm2tgm.py THIS HEADER COMMENT PREVENTS RECONVERSION, DO NOT REMOVE
"a" = (
/turf/template_noop,
/area/template_noop)
"b" = (
/obj/structure/lattice/catwalk,
/turf/open/space/basic,
/area/space/nearstation)
"c" = (
/obj/effect/turf_decal/stripes/line,
/turf/open/floor/engine,
/area/station/cargo/exploration_office)
"d" = (
/obj/effect/turf_decal/stripes/line{
	dir = 10
	},
/obj/structure/sign/poster/official/safety_internals/directional/west,
/obj/machinery/atmospherics/pipe/smart/manifold4w/supply/hidden/layer4,
/turf/open/floor/engine,
/area/station/cargo/exploration_office)
"f" = (
/obj/machinery/light/directional/north,
/obj/machinery/portable_atmospherics/canister/oxygen,
/turf/open/floor/iron/dark,
/area/station/cargo/exploration_office)
"g" = (
/obj/structure/tank_dispenser/oxygen,
/obj/machinery/camera/autoname/directional/west,
/turf/open/floor/iron/dark,
/area/station/cargo/exploration_office)
"h" = (
/turf/open/floor/iron/dark,
/area/station/cargo/exploration_office)
"i" = (
/obj/machinery/computer/anchor_controller{
	dir = 1
	},
/turf/open/floor/iron/dark,
/area/station/cargo/exploration_office)
"j" = (
/obj/machinery/light_switch/directional/south,
/obj/structure/cable,
/obj/machinery/atmospherics/pipe/smart/manifold4w/supply/hidden/layer4,
/obj/machinery/atmospherics/pipe/smart/manifold4w/scrubbers/hidden/layer2,
/obj/effect/decal/cleanable/blood/old,
/turf/open/floor/iron/dark,
/area/station/cargo/exploration_office)
"m" = (
/obj/structure/rack,
/obj/item/multitool{
	pixel_x = -7;
	pixel_y = 2
	},
/obj/item/stack/impure_telecrystal{
	pixel_x = -6;
	pixel_y = -2
	},
/obj/machinery/camera/autoname/directional/east,
/obj/structure/sign/warning/vacuum/external/directional/east,
/obj/item/storage/box/nri_flares{
	layer = 2.99;
	pixel_y = 1;
	pixel_x = 3
	},
/turf/open/floor/iron/dark,
/area/station/cargo/exploration_office)
"n" = (
/obj/structure/bed/dogbed{
	name = "Lem's bed";
	desc = "A comfy-looking cat bed. You can even strap your pet in, in case the gravity turns off."
	},
/mob/living/basic/pet/cat/space{
	name = "Lem";
	gender = "male";
	unique_pet = 1;
	desc = "He's kittened out for space exploration."
	},
/turf/open/floor/iron/dark,
/area/station/cargo/exploration_office)
"o" = (
/obj/machinery/suit_storage_unit/explorer,
/obj/effect/turf_decal/bot,
/turf/open/floor/iron/dark,
/area/station/cargo/exploration_office)
"p" = (
/obj/machinery/light/small/directional/south,
/turf/open/floor/iron/dark,
/area/station/cargo/exploration_office)
"q" = (
/obj/effect/decal/cleanable/dirt,
/obj/effect/cult_turf,
/obj/structure/cable,
/obj/machinery/atmospherics/pipe/smart/manifold4w/supply/hidden/layer4,
/obj/machinery/atmospherics/pipe/smart/manifold4w/scrubbers/hidden/layer2,
/turf/open/floor/iron,
/area/station/maintenance/fore/lesser)
"r" = (
/obj/effect/turf_decal/stripes/line{
	dir = 8
	},
/obj/machinery/door/airlock/external{
	name = "Exploration Office Airlock";
	space_dir = 1
	},
/obj/effect/mapping_helpers/airlock/cyclelink_helper_multi{
	cycle_id = "exploration-office-airlock"
	},
/obj/effect/mapping_helpers/airlock/access/all/command/gateway,
/turf/open/floor/iron/dark,
/area/station/cargo/exploration_office)
"s" = (
/obj/structure/extinguisher_cabinet/directional/east,
/obj/effect/landmark/start/explorer,
/turf/open/floor/iron/dark,
/area/station/cargo/exploration_office)
"t" = (
/obj/machinery/atmospherics/pipe/smart/manifold4w/supply/hidden/layer4,
/turf/open/floor/iron/dark,
/area/station/cargo/exploration_office)
"v" = (
/obj/effect/turf_decal/stripes/line{
	dir = 1
	},
/obj/machinery/door/airlock/external{
	name = "Exploration Office Airlock";
	space_dir = 1
	},
/obj/effect/mapping_helpers/airlock/cyclelink_helper_multi{
	cycle_id = "exploration-office-airlock"
	},
/obj/effect/mapping_helpers/airlock/access/all/command/gateway,
/turf/open/floor/iron/dark,
/area/station/cargo/exploration_office)
"x" = (
/obj/machinery/atmospherics/components/unary/vent_pump/on/layer4{
	dir = 8
	},
/turf/open/floor/iron/dark,
/area/station/cargo/exploration_office)
"y" = (
/obj/effect/turf_decal/stripes/line{
	dir = 5
	},
/obj/effect/decal/cleanable/blood/oil,
/turf/open/floor/engine,
/area/station/cargo/exploration_office)
"A" = (
/obj/effect/landmark/start/explorer,
/obj/machinery/atmospherics/components/unary/vent_scrubber/on/layer2{
	dir = 8
	},
/turf/open/floor/iron/dark,
/area/station/cargo/exploration_office)
"B" = (
/obj/effect/turf_decal/stripes/line{
	dir = 1
	},
/turf/open/floor/engine,
/area/station/cargo/exploration_office)
"D" = (
/obj/effect/turf_decal/stripes/line{
	dir = 6
	},
/turf/open/floor/engine,
/area/station/cargo/exploration_office)
"F" = (
/obj/structure/table/reinforced,
/obj/item/paper_bin{
	pixel_y = 4;
	pixel_x = -7
	},
/obj/item/pen,
/obj/machinery/recharger{
	pixel_x = 6;
	pixel_y = 3
	},
/turf/open/floor/iron/dark,
/area/station/cargo/exploration_office)
"G" = (
/obj/effect/turf_decal/stripes/line{
	dir = 9
	},
/obj/structure/sign/poster/abductor/ayylian/directional/west,
/obj/machinery/atmospherics/pipe/smart/manifold4w/supply/hidden/layer4,
/turf/open/floor/engine,
/area/station/cargo/exploration_office)
"H" = (
/obj/effect/turf_decal/stripes/line{
	dir = 8
	},
/obj/machinery/light/directional/west,
/obj/machinery/atmospherics/pipe/smart/manifold4w/supply/hidden/layer4,
/turf/open/floor/engine,
/area/station/cargo/exploration_office)
"I" = (
/obj/machinery/airalarm/directional/north,
/turf/open/floor/iron/dark,
/area/station/cargo/exploration_office)
"J" = (
/obj/effect/spawner/structure/window/reinforced,
/turf/open/floor/plating,
/area/station/cargo/exploration_office)
"K" = (
/obj/machinery/light/directional/south,
/obj/structure/closet/crate/bin,
/obj/effect/spawner/random/trash/garbage,
/obj/effect/spawner/random/trash/garbage,
/turf/open/floor/iron/dark,
/area/station/cargo/exploration_office)
"L" = (
/obj/machinery/dive_anchor/stationary,
/obj/effect/turf_decal/stripes/box,
/turf/open/floor/engine,
/area/station/cargo/exploration_office)
"M" = (
/turf/open/floor/plating,
/area/space/nearstation)
"N" = (
/obj/structure/lattice/catwalk,
/obj/structure/sign/warning/directional/north,
/turf/open/space/basic,
/area/space/nearstation)
"O" = (
/obj/effect/turf_decal/stripes/line{
	dir = 4
	},
/turf/open/floor/engine,
/area/station/cargo/exploration_office)
"P" = (
/obj/machinery/atmospherics/pipe/smart/manifold4w/supply/hidden/layer4,
/obj/item/kirbyplants/random{
	pixel_x = -9
	},
/turf/open/floor/iron/dark,
/area/station/cargo/exploration_office)
"Q" = (
/obj/effect/landmark/navigate_destination/exploration_office,
/obj/machinery/door/airlock/mining{
	name = "Exploration Office"
	},
/obj/machinery/door/firedoor,
/obj/effect/mapping_helpers/airlock/access/any/command/gateway,
/obj/machinery/atmospherics/pipe/smart/manifold4w/supply/hidden/layer4,
/obj/machinery/atmospherics/pipe/smart/manifold4w/scrubbers/hidden/layer2,
/obj/structure/cable,
/turf/open/floor/iron/dark,
/area/station/cargo/exploration_office)
"R" = (
/obj/effect/mapping_helpers/broken_floor,
/obj/effect/cult_turf,
/obj/structure/cable,
/obj/machinery/atmospherics/pipe/smart/manifold4w/supply/hidden/layer4,
/obj/machinery/atmospherics/pipe/smart/manifold4w/scrubbers/hidden/layer2,
/turf/open/floor/iron,
/area/station/maintenance/fore/lesser)
"S" = (
/obj/structure/cable,
/obj/machinery/atmospherics/pipe/smart/manifold4w/supply/hidden/layer4,
/obj/machinery/atmospherics/pipe/smart/manifold4w/scrubbers/hidden/layer2,
/turf/open/floor/iron/dark,
/area/station/cargo/exploration_office)
"T" = (
/obj/structure/lattice,
/turf/open/space/basic,
/area/space/nearstation)
"U" = (
/turf/closed/wall,
/area/station/cargo/exploration_office)
"V" = (
/obj/effect/decal/cleanable/plasma,
/obj/effect/cult_turf,
/obj/structure/cable,
/obj/machinery/atmospherics/pipe/smart/manifold4w/supply/hidden/layer4,
/obj/machinery/atmospherics/pipe/smart/manifold4w/scrubbers/hidden/layer2,
/turf/open/floor/iron,
/area/station/maintenance/fore/lesser)
"W" = (
/obj/machinery/dive_anchor,
/turf/open/space/basic,
/area/space/nearstation)
"X" = (
/obj/machinery/power/apc/auto_name/directional/north,
/obj/structure/cable,
/obj/machinery/recharge_station,
/obj/effect/turf_decal/bot,
/turf/open/floor/iron/dark,
/area/station/cargo/exploration_office)
"Y" = (
/obj/machinery/firealarm/directional/east,
/turf/open/floor/iron/dark,
/area/station/cargo/exploration_office)
"Z" = (
/obj/structure/chair/office,
/obj/effect/landmark/start/explorer,
/obj/effect/decal/cleanable/cobweb,
/turf/open/floor/iron/dark,
/area/station/cargo/exploration_office)

(1,1,1) = {"
a
a
q
R
a
a
a
a
a
a
a
"}
(2,1,1) = {"
a
a
V
a
a
a
a
a
a
a
a
"}
(3,1,1) = {"
a
a
Q
a
a
a
a
a
a
a
a
"}
(4,1,1) = {"
a
g
j
a
a
a
a
a
Z
i
U
"}
(5,1,1) = {"
a
X
S
t
G
H
d
P
t
F
U
"}
(6,1,1) = {"
a
f
A
h
B
L
c
h
x
K
U
"}
(7,1,1) = {"
a
I
h
Y
y
O
D
s
h
n
U
"}
(8,1,1) = {"
a
o
o
U
J
J
J
U
h
m
U
"}
(9,1,1) = {"
a
U
U
U
N
b
b
U
r
U
U
"}
(10,1,1) = {"
a
a
T
T
b
W
b
v
p
U
a
"}
(11,1,1) = {"
a
a
a
a
b
b
b
U
J
U
a
"}

(1,1,2) = {"
a
a
a
a
a
a
a
a
a
a
a
"}
(2,1,2) = {"
a
a
a
a
a
a
a
a
a
a
a
"}
(3,1,2) = {"
a
a
a
M
a
a
a
a
a
a
a
"}
(4,1,2) = {"
a
M
M
M
a
a
a
a
a
a
a
"}
(5,1,2) = {"
a
M
M
M
a
a
a
a
a
a
a
"}
(6,1,2) = {"
a
M
M
M
a
a
a
a
a
a
a
"}
(7,1,2) = {"
a
M
M
M
a
a
a
a
a
a
a
"}
(8,1,2) = {"
a
M
M
M
a
a
a
a
a
a
a
"}
(9,1,2) = {"
a
M
M
M
a
a
a
a
a
a
M
"}
(10,1,2) = {"
a
a
a
a
a
a
a
a
a
M
a
"}
(11,1,2) = {"
a
a
a
a
a
a
a
a
a
M
a
"}
