//MAP CONVERTED BY dmm2tgm.py THIS HEADER COMMENT PREVENTS RECONVERSION, DO NOT REMOVE
"a" = (
/obj/effect/turf_decal/siding/wood{
	dir = 1
	},
/obj/effect/turf_decal/siding/wood/corner{
	dir = 8
	},
/obj/machinery/button/door/directional/north{
	id = "capoffice";
	name = "Privacy Control";
	pixel_y = 26;
	req_access = list("captain");
	pixel_x = -7
	},
/obj/machinery/light/directional/north,
/obj/machinery/camera/autoname/directional/north,
/obj/machinery/keycard_auth/wall_mounted/directional/north{
	pixel_x = 6;
	pixel_y = 24
	},
/obj/machinery/light_switch/directional/north{
	pixel_y = 36;
	pixel_x = -7
	},
/obj/structure/phone_base/captain{
	pixel_x = 5;
	pixel_y = 41
	},
/turf/open/floor/wood/large,
/area/station/command/heads_quarters/captain)

(1,1,1) = {"
a
"}
