//MAP CONVERTED BY dmm2tgm.py THIS HEADER COMMENT PREVENTS RECONVERSION, DO NOT REMOVE
"a" = (
/obj/structure/table/reinforced/rglass,
/obj/effect/turf_decal/siding/wideplating_new/dark{
	dir = 4
	},
/obj/machinery/fax{
	fax_name = "Bridge";
	name = "Bridge Fax Machine"
	},
/turf/open/floor/iron/dark/herringbone,
/area/station/command/bridge)

(1,1,1) = {"
a
"}
