//MAP CONVERTED BY dmm2tgm.py THIS HEADER COMMENT PREVENTS RECONVERSION, DO NOT REMOVE
"a" = (
/turf/template_noop,
/area/template_noop)
"h" = (
/obj/machinery/atmospherics/pipe/smart/manifold4w/supply/hidden/layer4,
/obj/effect/turf_decal/stripes/line,
/obj/effect/landmark/start/explorer,
/turf/open/floor/iron,
/area/station/command/gateway)
"E" = (
/obj/structure/chair/stool/directional/north,
/obj/structure/cable,
/obj/effect/turf_decal/tile/blue/opposingcorners,
/obj/machinery/light/small/directional/west,
/obj/effect/landmark/start/explorer,
/turf/open/floor/iron/dark,
/area/station/command/gateway)
"Z" = (
/obj/effect/landmark/start/explorer,
/turf/open/floor/iron,
/area/station/command/gateway)

(1,1,1) = {"
a
E
a
"}
(2,1,1) = {"
a
a
a
"}
(3,1,1) = {"
a
a
a
"}
(4,1,1) = {"
Z
a
a
"}
(5,1,1) = {"
a
a
h
"}
