//MAP CONVERTED BY dmm2tgm.py THIS HEADER COMMENT PREVENTS RECONVERSION, DO NOT REMOVE
"aC" = (
/obj/structure/rack,
/obj/item/stack/sheet/mineral/coal,
/turf/open/floor/stone/lavaland,
/area/lavaland/surface/outdoors)
"aT" = (
/obj/item/pickaxe/emergency,
/turf/open/misc/asteroid/basalt/lava_land_surface,
/area/lavaland/surface/outdoors)
"dh" = (
/obj/item/gun/energy/laser/musket/prime,
/turf/open/floor/pod/dark,
/area/ruin/powered)
"eb" = (
/obj/item/instrument/guitar,
/turf/open/misc/asteroid/basalt/lava_land_surface,
/area/lavaland/surface/outdoors)
"eA" = (
/obj/structure/glowshroom/single,
/turf/open/misc/asteroid/basalt/lava_land_surface,
/area/lavaland/surface/outdoors)
"eO" = (
/obj/effect/spawner/structure/window/reinforced/shuttle,
/turf/open/floor/plating{
	initial_gas_mix = "LAVALAND_ATMOS"
	},
/area/ruin/powered)
"gO" = (
/obj/item/seeds/cotton,
/turf/open/misc/asteroid/basalt/lava_land_surface,
/area/lavaland/surface/outdoors)
"hd" = (
/obj/structure/railing{
	dir = 1
	},
/turf/open/misc/asteroid/basalt/lava_land_surface,
/area/lavaland/surface/outdoors)
"ho" = (
/obj/structure/chair/pew/right{
	dir = 8
	},
/turf/open/misc/asteroid/basalt/lava_land_surface,
/area/lavaland/surface/outdoors)
"kC" = (
/obj/item/wallframe/emcloset,
/turf/closed/wall/mineral/titanium/interior,
/area/ruin/powered)
"kX" = (
/turf/open/floor/mineral/titanium/blue,
/area/ruin/powered)
"mE" = (
/obj/item/knife/combat/survival,
/turf/open/floor/stone/lavaland,
/area/lavaland/surface/outdoors)
"mV" = (
/obj/item/storage/backpack/duffelbag,
/turf/open/floor/pod/dark/lavaland,
/area/lavaland/surface/outdoors)
"qx" = (
/obj/structure/railing{
	dir = 8
	},
/turf/open/misc/asteroid/basalt/lava_land_surface,
/area/lavaland/surface/outdoors)
"tt" = (
/obj/machinery/light/small/directional/east,
/turf/open/floor/stone/lavaland,
/area/lavaland/surface/outdoors)
"vb" = (
/obj/structure/chair/pew/left{
	dir = 8
	},
/turf/open/misc/asteroid/basalt/lava_land_surface,
/area/lavaland/surface/outdoors)
"wg" = (
/obj/item/storage/backpack/satchel/leather,
/turf/open/floor/pod/dark/lavaland,
/area/lavaland/surface/outdoors)
"xN" = (
/turf/closed/wall/mineral/titanium/interior,
/area/ruin/powered)
"xW" = (
/obj/structure/table/survival_pod,
/obj/item/storage/toolbox/emergency,
/turf/open/floor/pod/dark/lavaland,
/area/lavaland/surface/outdoors)
"yy" = (
/obj/machinery/portable_atmospherics/canister/oxygen,
/turf/open/floor/pod/dark,
/area/ruin/powered)
"AT" = (
/turf/open/floor/pod/dark/lavaland,
/area/lavaland/surface/outdoors)
"Df" = (
/turf/open/floor/plating/lavaland_atmos,
/area/lavaland/surface/outdoors)
"DP" = (
/obj/structure/bonfire/prelit,
/turf/open/floor/stone/lavaland,
/area/lavaland/surface/outdoors)
"FU" = (
/obj/structure/reagent_forge,
/turf/open/floor/stone/lavaland,
/area/lavaland/surface/outdoors)
"GQ" = (
/obj/machinery/rnd/production/colony_lathe,
/obj/machinery/light/small/directional/south,
/turf/open/floor/pod/dark,
/area/ruin/powered)
"HU" = (
/turf/closed/wall/mineral/titanium/survival/pod,
/area/lavaland/surface/outdoors)
"IT" = (
/obj/item/cultivator,
/turf/open/misc/asteroid/basalt/lava_land_surface,
/area/lavaland/surface/outdoors)
"Jh" = (
/obj/structure/fans,
/turf/open/floor/pod/dark,
/area/ruin/powered)
"Lm" = (
/turf/closed/mineral/volcanic/lava_land_surface,
/area/lavaland/surface/outdoors)
"MA" = (
/obj/item/flashlight/lantern/on,
/turf/open/misc/asteroid/basalt/lava_land_surface,
/area/lavaland/surface/outdoors)
"MD" = (
/obj/machinery/modular_computer{
	dir = 8
	},
/turf/open/floor/mineral/titanium/blue,
/area/ruin/powered)
"MP" = (
/turf/closed/wall/mineral/titanium/survival/pod,
/area/ruin/powered)
"NO" = (
/obj/structure/closet/cabinet,
/obj/item/clothing/under/costume/gladiator/ash_walker/caesar_clothes,
/obj/item/clothing/under/costume/gladiator/ash_walker/yellow,
/obj/item/clothing/under/costume/gladiator/ash_walker/ash_robes,
/obj/item/clothing/under/costume/gladiator/ash_walker/robe,
/obj/item/clothing/gloves/fingerless/primitive_catgirl_armwraps,
/obj/item/clothing/gloves/fingerless/primitive_catgirl_gauntlets,
/turf/open/misc/asteroid/basalt/lava_land_surface,
/area/lavaland/surface/outdoors)
"Ok" = (
/obj/structure/rack,
/obj/item/seeds/reishi,
/obj/item/seeds/plump,
/obj/item/seeds/plump,
/obj/item/food/grown/mushroom/glowshroom,
/obj/item/seeds/tower,
/turf/open/misc/asteroid/basalt/lava_land_surface,
/area/lavaland/surface/outdoors)
"On" = (
/obj/structure/tubes,
/obj/effect/mob_spawn/ghost_role/human/hermit,
/obj/item/tank/internals/oxygen,
/turf/open/floor/pod/dark,
/area/ruin/powered)
"OR" = (
/obj/machinery/door/airlock/survival_pod/glass,
/obj/structure/fans/tiny,
/turf/open/floor/plating{
	initial_gas_mix = "LAVALAND_ATMOS"
	},
/area/ruin/powered)
"PN" = (
/obj/item/shovel,
/turf/open/misc/asteroid/basalt/lava_land_surface,
/area/lavaland/surface/outdoors)
"PY" = (
/obj/item/reagent_containers/cup/glass/waterbottle/large,
/obj/structure/table,
/obj/item/reagent_containers/cup/glass/waterbottle/large,
/obj/item/reagent_containers/cup/glass/waterbottle/large,
/turf/open/floor/stone/lavaland,
/area/lavaland/surface/outdoors)
"PZ" = (
/obj/machinery/door/airlock/titanium{
	name = "Escape Pod Airlock"
	},
/obj/structure/fans/tiny,
/turf/open/floor/plating{
	initial_gas_mix = "LAVALAND_ATMOS"
	},
/area/ruin/powered)
"QB" = (
/obj/item/toy/plush/lizard_plushie/space/green{
	name = "Stranded-On-Lavaland";
	desc = "An adorable stuffed toy that resembles a very determined spacefaring green lizardperson. To infinity and beyond, little guy. This one fills you with nostalgia and soul. Its lost and alone, just like you!"
	},
/turf/open/misc/asteroid/basalt/lava_land_surface,
/area/lavaland/surface/outdoors)
"QZ" = (
/obj/structure/rack,
/obj/item/storage/bag/plants/portaseeder,
/obj/item/storage/bag/ore,
/obj/item/storage/medkit/regular,
/turf/open/misc/asteroid/basalt/lava_land_surface,
/area/lavaland/surface/outdoors)
"Rw" = (
/turf/open/floor/stone/lavaland,
/area/lavaland/surface/outdoors)
"RN" = (
/obj/machinery/power/shuttle_engine/propulsion/burst{
	dir = 8
	},
/turf/closed/wall/mineral/titanium/interior,
/area/ruin/powered)
"ST" = (
/obj/machinery/smartfridge/survival_pod/preloaded,
/obj/machinery/light/small/directional/north,
/turf/open/floor/pod/dark,
/area/ruin/powered)
"Vx" = (
/turf/template_noop,
/area/template_noop)
"VK" = (
/obj/structure/railing{
	dir = 4
	},
/turf/open/misc/asteroid/basalt/lava_land_surface,
/area/lavaland/surface/outdoors)
"VT" = (
/turf/open/misc/asteroid/basalt/lava_land_surface,
/area/lavaland/surface/outdoors)
"XN" = (
/obj/item/clothing/head/utility/welding,
/obj/machinery/light/small/directional/west,
/turf/open/floor/pod/dark/lavaland,
/area/lavaland/surface/outdoors)
"Yf" = (
/obj/structure/railing,
/turf/open/misc/asteroid/basalt/lava_land_surface,
/area/lavaland/surface/outdoors)

(1,1,1) = {"
Vx
Vx
Vx
Vx
Vx
Vx
Vx
Vx
Vx
Vx
Vx
Vx
Vx
Vx
Vx
Vx
"}
(2,1,1) = {"
Lm
Lm
Lm
Lm
Lm
Lm
Lm
Vx
Vx
Vx
Vx
Vx
Vx
Vx
Vx
Vx
"}
(3,1,1) = {"
Lm
RN
eO
RN
Lm
Lm
Lm
Lm
HU
Lm
Lm
Vx
Vx
Vx
Vx
Vx
"}
(4,1,1) = {"
MP
MP
yy
MP
MP
Lm
HU
wg
XN
xW
Lm
Lm
Vx
Vx
Vx
Vx
"}
(5,1,1) = {"
kC
On
dh
GQ
xN
VT
VT
VT
AT
mV
HU
VT
VT
VT
Vx
Vx
"}
(6,1,1) = {"
xN
Jh
kX
kX
PZ
Df
VT
VT
VT
VT
VT
VT
aT
MA
VT
Vx
"}
(7,1,1) = {"
MP
ST
kX
kX
OR
Df
Df
VT
VT
VT
VT
VT
VT
eA
VT
Vx
"}
(8,1,1) = {"
MP
xN
MD
xN
xN
VT
VT
eA
VT
VK
VT
VT
VT
VT
VT
Lm
"}
(9,1,1) = {"
Lm
MP
eO
xN
Lm
VT
VT
VT
Yf
DP
hd
VT
VT
VT
Lm
Lm
"}
(10,1,1) = {"
Lm
Lm
Lm
Lm
Lm
VT
VT
VT
VT
qx
eb
eA
VT
VT
gO
Lm
"}
(11,1,1) = {"
Vx
Vx
Lm
QB
Lm
Lm
mE
VT
vb
ho
VT
VT
VT
VT
Ok
Lm
"}
(12,1,1) = {"
Vx
Vx
Lm
Lm
Lm
FU
Rw
VT
VT
VT
VT
VT
PN
VT
Lm
Lm
"}
(13,1,1) = {"
Vx
Vx
Vx
Lm
Lm
aC
tt
Rw
VT
VT
Lm
VT
VT
IT
Lm
Vx
"}
(14,1,1) = {"
Vx
Vx
Vx
Vx
Lm
Lm
HU
PY
NO
Lm
Lm
QZ
VT
Lm
Lm
Vx
"}
(15,1,1) = {"
Vx
Vx
Vx
Vx
Vx
Vx
Lm
Lm
Lm
Lm
Lm
Lm
Lm
Lm
Vx
Vx
"}
(16,1,1) = {"
Vx
Vx
Vx
Vx
Vx
Vx
Vx
Vx
Vx
Vx
Vx
Vx
Vx
Vx
Vx
Vx
"}
