//MAP CONVERTED BY dmm2tgm.py THIS HEADER COMMENT PREVENTS RECONVERSION, DO NOT REMOVE
"al" = (
/obj/structure/stone_tile/block{
	dir = 8
	},
/obj/structure/stone_tile/cracked,
/turf/open/lava/smooth/lava_land_surface{
	slowdown = 0
	},
/area/ruin/unpowered/marked_one_arena)
"ar" = (
/obj/structure/stone_tile/surrounding_tile,
/obj/structure/stone_tile/surrounding_tile{
	dir = 8
	},
/obj/structure/stone_tile/surrounding_tile{
	dir = 1
	},
/obj/structure/stone_tile/surrounding_tile{
	dir = 4
	},
/obj/structure/stone_tile/center,
/mob/living/simple_animal/hostile/megafauna/gladiator,
/turf/open/lava/smooth/lava_land_surface{
	slowdown = 0
	},
/area/ruin/unpowered/marked_one_arena)
"ba" = (
/obj/structure/stone_tile{
	dir = 8
	},
/obj/structure/stone_tile{
	dir = 4
	},
/turf/open/lava/smooth/lava_land_surface{
	slowdown = 0
	},
/area/ruin/unpowered/marked_one_arena)
"bc" = (
/obj/structure/stone_tile,
/obj/structure/stone_tile{
	dir = 8
	},
/obj/structure/stone_tile{
	dir = 4
	},
/obj/structure/stone_tile{
	dir = 1
	},
/obj/effect/gibspawner/human,
/obj/item/gun/energy/recharge/kinetic_accelerator,
/turf/open/indestructible/boss,
/area/ruin/unpowered/marked_one_arena)
"bm" = (
/obj/item/paper/crumpled/bloody{
	color = "#D2B48C";
	default_raw_text = "The myth was more than real - I now stand as a paragon of my ancestors' might before the arena of the Great Necropolis. The tales tell of a warrior inside, an outsider given favor by the holy city. It is blasphemous. If such a creature truly lies within, it is my duty as tribemaster to slay them with great prejudice. Such abhorrent things cannot be allowed to defile the Necropolis's blessed lands.";
	name = "ash-coated note"
	},
/turf/open/misc/asteroid/basalt/lava_land_surface,
/area/lavaland/surface/outdoors)
"bZ" = (
/obj/structure/stone_tile{
	dir = 4
	},
/obj/structure/stone_tile/block,
/turf/open/lava/smooth/lava_land_surface{
	slowdown = 0
	},
/area/ruin/unpowered/marked_one_arena)
"cA" = (
/obj/structure/stone_tile,
/obj/structure/stone_tile{
	dir = 8
	},
/obj/structure/stone_tile{
	dir = 4
	},
/obj/structure/stone_tile{
	dir = 1
	},
/obj/item/spear/bonespear,
/turf/open/indestructible/boss,
/area/ruin/unpowered/marked_one_arena)
"cN" = (
/obj/structure/stone_tile/slab,
/obj/effect/gibspawner/human,
/turf/open/lava/smooth/lava_land_surface{
	slowdown = 0
	},
/area/ruin/unpowered/marked_one_arena)
"dR" = (
/obj/structure/stone_tile/block{
	dir = 4
	},
/obj/structure/stone_tile{
	dir = 4
	},
/obj/structure/stone_tile{
	dir = 8
	},
/turf/open/lava/smooth/lava_land_surface{
	slowdown = 0
	},
/area/ruin/unpowered/marked_one_arena)
"ey" = (
/obj/structure/stone_tile/block{
	dir = 4
	},
/obj/structure/stone_tile{
	dir = 8
	},
/obj/structure/stone_tile{
	dir = 4
	},
/mob/living/basic/mining/hivelord/no_wander{
	color = "red";
	name = "gate guardian"
	},
/turf/open/lava/smooth/lava_land_surface{
	slowdown = 0
	},
/area/ruin/unpowered/marked_one_arena)
"ga" = (
/obj/structure/stone_tile/slab,
/obj/item/paper/crumpled/bloody{
	color = "#D2B48C";
	default_raw_text = "i just want to see them again";
	text = null
	},
/turf/open/indestructible/boss,
/area/ruin/unpowered/marked_one_arena)
"gJ" = (
/turf/closed/indestructible/riveted/boss,
/area/ruin/unpowered/marked_one_arena)
"hN" = (
/obj/structure/stone_tile/surrounding_tile,
/obj/structure/stone_tile/surrounding_tile{
	dir = 8
	},
/obj/structure/stone_tile/center,
/turf/open/lava/smooth/lava_land_surface{
	slowdown = 0
	},
/area/ruin/unpowered/marked_one_arena)
"ia" = (
/obj/structure/stone_tile,
/obj/structure/stone_tile{
	dir = 8
	},
/obj/structure/stone_tile{
	dir = 4
	},
/obj/structure/stone_tile{
	dir = 1
	},
/obj/item/knife/combat/bone,
/turf/open/lava/smooth/lava_land_surface{
	slowdown = 0
	},
/area/ruin/unpowered/marked_one_arena)
"ie" = (
/obj/structure/stone_tile/block{
	dir = 1
	},
/obj/structure/stone_tile,
/obj/structure/stone_tile{
	dir = 8
	},
/turf/open/lava/smooth/lava_land_surface{
	slowdown = 0
	},
/area/ruin/unpowered/marked_one_arena)
"ii" = (
/obj/structure/stone_tile/slab,
/obj/item/paper/crumpled/bloody{
	color = "#D2B48C";
	default_raw_text = "i understand";
	text = null
	},
/turf/open/indestructible/boss,
/area/ruin/unpowered/marked_one_arena)
"jg" = (
/obj/structure/stone_tile{
	dir = 4
	},
/obj/structure/stone_tile{
	dir = 8
	},
/obj/structure/stone_tile,
/obj/structure/stone_tile{
	dir = 1
	},
/turf/open/lava/smooth/lava_land_surface{
	slowdown = 0
	},
/area/ruin/unpowered/marked_one_arena)
"kO" = (
/obj/structure/stone_tile/block{
	dir = 1
	},
/obj/structure/stone_tile{
	dir = 8
	},
/obj/structure/stone_tile,
/turf/open/indestructible/boss,
/area/ruin/unpowered/marked_one_arena)
"lf" = (
/obj/structure/stone_tile/block{
	dir = 4
	},
/obj/structure/stone_tile{
	dir = 8
	},
/obj/structure/stone_tile{
	dir = 4
	},
/turf/open/lava/smooth/lava_land_surface{
	slowdown = 0
	},
/area/ruin/unpowered/marked_one_arena)
"ly" = (
/obj/structure/stone_tile{
	dir = 4
	},
/obj/structure/stone_tile{
	dir = 1
	},
/obj/structure/stone_tile/cracked,
/turf/open/lava/smooth/lava_land_surface{
	slowdown = 0
	},
/area/ruin/unpowered/marked_one_arena)
"lH" = (
/obj/structure/stone_tile{
	dir = 1
	},
/obj/structure/stone_tile/block,
/turf/open/lava/smooth/lava_land_surface{
	slowdown = 0
	},
/area/ruin/unpowered/marked_one_arena)
"lJ" = (
/obj/structure/statue/bone/rib{
	dir = 1
	},
/turf/open/misc/asteroid/basalt/lava_land_surface,
/area/lavaland/surface/outdoors)
"lT" = (
/obj/structure/stone_tile/block{
	dir = 8
	},
/obj/structure/stone_tile{
	dir = 1
	},
/obj/structure/stone_tile,
/obj/item/knife/combat/bone,
/turf/open/lava/smooth/lava_land_surface{
	slowdown = 0
	},
/area/ruin/unpowered/marked_one_arena)
"mZ" = (
/obj/structure/stone_tile,
/obj/structure/stone_tile{
	dir = 8
	},
/obj/structure/stone_tile{
	dir = 4
	},
/obj/structure/stone_tile{
	dir = 1
	},
/obj/effect/decal/remains/human{
	desc = "They look like remains, whether ash walker or miner you cannot tell. They have a strange aura about them."
	},
/obj/item/clothing/head/helmet/gladiator,
/turf/open/lava/smooth/lava_land_surface{
	slowdown = 0
	},
/area/ruin/unpowered/marked_one_arena)
"nc" = (
/obj/structure/stone_tile/block{
	dir = 4
	},
/obj/structure/stone_tile{
	dir = 4
	},
/turf/open/lava/smooth/lava_land_surface{
	slowdown = 0
	},
/area/ruin/unpowered/marked_one_arena)
"ne" = (
/obj/structure/stone_tile/block{
	dir = 8
	},
/obj/structure/stone_tile{
	dir = 1
	},
/obj/structure/stone_tile,
/turf/open/lava/smooth/lava_land_surface{
	slowdown = 0
	},
/area/ruin/unpowered/marked_one_arena)
"nA" = (
/obj/structure/stone_tile/block{
	dir = 8
	},
/obj/structure/stone_tile,
/obj/structure/stone_tile{
	dir = 1
	},
/mob/living/basic/mining/hivelord/no_wander{
	color = "red";
	name = "gate guardian"
	},
/turf/open/lava/smooth/lava_land_surface{
	slowdown = 0
	},
/area/ruin/unpowered/marked_one_arena)
"ot" = (
/obj/structure/stone_tile/slab,
/obj/effect/decal/remains/human{
	desc = "They look like remains, whether ash walker or miner you cannot tell. They have a strange aura about them."
	},
/turf/open/indestructible/boss,
/area/ruin/unpowered/marked_one_arena)
"oW" = (
/obj/structure/stone_tile{
	dir = 8
	},
/obj/structure/stone_tile{
	dir = 1
	},
/obj/structure/stone_tile,
/turf/open/lava/smooth/lava_land_surface{
	slowdown = 0
	},
/area/ruin/unpowered/marked_one_arena)
"pF" = (
/obj/structure/stone_tile,
/obj/structure/stone_tile{
	dir = 8
	},
/obj/structure/stone_tile{
	dir = 4
	},
/obj/structure/stone_tile{
	dir = 1
	},
/turf/open/lava/smooth/lava_land_surface{
	slowdown = 0
	},
/area/ruin/unpowered/marked_one_arena)
"pJ" = (
/obj/structure/stone_tile{
	dir = 1
	},
/obj/structure/stone_tile,
/obj/structure/stone_tile{
	dir = 8
	},
/obj/structure/stone_tile/cracked{
	dir = 4
	},
/turf/open/lava/smooth/lava_land_surface{
	slowdown = 0
	},
/area/ruin/unpowered/marked_one_arena)
"pM" = (
/obj/structure/stone_tile/surrounding,
/obj/structure/stone_tile/center,
/turf/open/lava/smooth/lava_land_surface{
	slowdown = 0
	},
/area/ruin/unpowered/marked_one_arena)
"qU" = (
/obj/structure/stone_tile/block{
	dir = 1
	},
/obj/structure/stone_tile,
/obj/structure/stone_tile{
	dir = 8
	},
/obj/item/knife/combat/bone,
/turf/open/lava/smooth/lava_land_surface{
	slowdown = 0
	},
/area/ruin/unpowered/marked_one_arena)
"si" = (
/obj/structure/stone_tile/slab,
/obj/item/spear/bonespear,
/turf/open/indestructible/boss,
/area/ruin/unpowered/marked_one_arena)
"sL" = (
/obj/structure/stone_tile/block{
	dir = 8
	},
/obj/structure/stone_tile{
	dir = 1
	},
/obj/structure/stone_tile,
/turf/open/indestructible/boss,
/area/ruin/unpowered/marked_one_arena)
"tJ" = (
/obj/item/paper/crumpled/bloody{
	color = "#D2B48C";
	default_raw_text = "the ash is so warm but the air is so cold where did they go why am i left here"
	},
/turf/open/misc/asteroid/basalt/lava_land_surface,
/area/lavaland/surface/outdoors)
"ug" = (
/obj/structure/stone_tile/block{
	dir = 8
	},
/obj/structure/stone_tile,
/obj/structure/stone_tile{
	dir = 1
	},
/turf/open/indestructible/boss,
/area/ruin/unpowered/marked_one_arena)
"up" = (
/obj/structure/stone_tile/slab,
/obj/effect/decal/remains/human{
	desc = "They look like remains, whether ash walker or miner you cannot tell. They have a strange aura about them."
	},
/obj/item/clothing/head/helmet/gladiator,
/turf/open/indestructible/boss,
/area/ruin/unpowered/marked_one_arena)
"uv" = (
/obj/structure/stone_tile/block{
	dir = 4
	},
/obj/structure/stone_tile/block{
	dir = 8
	},
/turf/open/lava/smooth/lava_land_surface{
	slowdown = 0
	},
/area/ruin/unpowered/marked_one_arena)
"uM" = (
/obj/structure/stone_tile,
/obj/structure/stone_tile{
	dir = 4
	},
/turf/open/lava/smooth/lava_land_surface{
	slowdown = 0
	},
/area/ruin/unpowered/marked_one_arena)
"vw" = (
/obj/structure/stone_tile,
/obj/structure/stone_tile{
	dir = 4
	},
/obj/structure/stone_tile{
	dir = 8
	},
/obj/structure/stone_tile{
	dir = 1
	},
/turf/open/lava/smooth/lava_land_surface{
	slowdown = 0
	},
/area/ruin/unpowered/marked_one_arena)
"vF" = (
/obj/structure/stone_tile/block{
	dir = 8
	},
/obj/structure/stone_tile{
	dir = 1
	},
/obj/structure/stone_tile,
/turf/open/indestructible/boss,
/area/lavaland/surface/outdoors)
"vL" = (
/obj/structure/stone_tile/block{
	dir = 1
	},
/obj/structure/stone_tile{
	dir = 8
	},
/turf/open/lava/smooth/lava_land_surface{
	slowdown = 0
	},
/area/ruin/unpowered/marked_one_arena)
"wQ" = (
/obj/structure/stone_tile/slab,
/turf/open/lava/smooth/lava_land_surface{
	slowdown = 0
	},
/area/lavaland/surface/outdoors)
"xc" = (
/obj/structure/stone_tile,
/obj/structure/stone_tile{
	dir = 8
	},
/obj/structure/stone_tile{
	dir = 4
	},
/obj/structure/stone_tile{
	dir = 1
	},
/obj/effect/decal/remains/human{
	desc = "They look like remains, whether ash walker or miner you cannot tell. They have a strange aura about them."
	},
/turf/open/indestructible/boss,
/area/ruin/unpowered/marked_one_arena)
"xh" = (
/obj/structure/stone_tile/block,
/obj/structure/stone_tile{
	dir = 4
	},
/obj/structure/stone_tile{
	dir = 1
	},
/turf/open/lava/smooth/lava_land_surface{
	slowdown = 0
	},
/area/ruin/unpowered/marked_one_arena)
"xn" = (
/obj/structure/stone_tile,
/obj/structure/stone_tile{
	dir = 8
	},
/obj/structure/stone_tile{
	dir = 4
	},
/obj/structure/stone_tile{
	dir = 1
	},
/obj/effect/decal/remains/human{
	desc = "They look like remains, whether ash walker or miner you cannot tell. They have a strange aura about them."
	},
/turf/open/lava/smooth/lava_land_surface{
	slowdown = 0
	},
/area/ruin/unpowered/marked_one_arena)
"xt" = (
/obj/structure/stone_tile/block{
	dir = 1
	},
/obj/structure/stone_tile/block,
/turf/open/lava/smooth/lava_land_surface{
	slowdown = 0
	},
/area/ruin/unpowered/marked_one_arena)
"xF" = (
/obj/item/spear/bonespear{
	color = "#c9554d";
	desc = "A more intricately constructed tribal bone spear with ritualistic carvings across the blade and shaft.";
	name = "the chosen's spear"
	},
/turf/open/misc/asteroid/basalt/lava_land_surface,
/area/lavaland/surface/outdoors)
"Aw" = (
/obj/structure/stone_tile/slab,
/obj/item/clothing/under/costume/gladiator,
/turf/open/indestructible/boss,
/area/ruin/unpowered/marked_one_arena)
"BX" = (
/obj/structure/stone_tile/slab/burnt,
/turf/open/indestructible/boss,
/area/ruin/unpowered/marked_one_arena)
"CJ" = (
/obj/structure/stone_tile/block{
	dir = 1
	},
/obj/structure/stone_tile{
	dir = 8
	},
/obj/structure/stone_tile,
/turf/open/lava/smooth/lava_land_surface{
	slowdown = 0
	},
/area/ruin/unpowered/marked_one_arena)
"CK" = (
/obj/structure/stone_tile/block{
	dir = 8
	},
/obj/structure/stone_tile{
	dir = 1
	},
/obj/structure/stone_tile,
/obj/item/claymore/bone,
/turf/open/lava/smooth/lava_land_surface{
	slowdown = 0
	},
/area/ruin/unpowered/marked_one_arena)
"CR" = (
/obj/structure/stone_tile/block,
/obj/structure/stone_tile{
	dir = 1
	},
/obj/structure/stone_tile{
	dir = 4
	},
/turf/open/lava/smooth/lava_land_surface{
	slowdown = 0
	},
/area/ruin/unpowered/marked_one_arena)
"Dc" = (
/obj/structure/stone_tile/slab,
/obj/structure/necropolis_arch,
/obj/structure/necropolis_gate{
	desc = "A massive stone gateway into a gladitorial arena. You feel like entering this unprepared would be your doom."
	},
/turf/open/lava/smooth/lava_land_surface{
	slowdown = 0
	},
/area/ruin/unpowered/marked_one_arena)
"Df" = (
/obj/structure/stone_tile,
/obj/structure/stone_tile{
	dir = 8
	},
/obj/structure/stone_tile{
	dir = 4
	},
/obj/structure/stone_tile{
	dir = 1
	},
/obj/effect/decal/remains/human{
	desc = "They look like remains, whether ash walker or miner you cannot tell. They have a strange aura about them."
	},
/obj/item/clothing/under/costume/gladiator/ash_walker,
/turf/open/indestructible/boss,
/area/ruin/unpowered/marked_one_arena)
"DE" = (
/obj/structure/stone_tile/block{
	dir = 8
	},
/obj/structure/stone_tile,
/obj/structure/stone_tile{
	dir = 1
	},
/mob/living/basic/mining/hivelord/no_wander{
	color = "red";
	name = "gate guardian"
	},
/turf/open/indestructible/boss,
/area/ruin/unpowered/marked_one_arena)
"DM" = (
/obj/structure/stone_tile/block{
	dir = 4
	},
/obj/structure/stone_tile{
	dir = 8
	},
/obj/structure/stone_tile{
	dir = 4
	},
/obj/effect/decal/remains/human{
	desc = "They look like remains, whether ash walker or miner you cannot tell. They have a strange aura about them."
	},
/turf/open/lava/smooth/lava_land_surface{
	slowdown = 0
	},
/area/ruin/unpowered/marked_one_arena)
"DN" = (
/obj/structure/stone_tile/block{
	dir = 1
	},
/obj/structure/stone_tile,
/turf/open/lava/smooth/lava_land_surface{
	slowdown = 0
	},
/area/ruin/unpowered/marked_one_arena)
"Fg" = (
/obj/structure/stone_tile/block,
/obj/structure/stone_tile/block/cracked{
	dir = 1
	},
/turf/open/lava/smooth/lava_land_surface{
	slowdown = 0
	},
/area/ruin/unpowered/marked_one_arena)
"FE" = (
/obj/structure/stone_tile{
	dir = 8
	},
/obj/structure/stone_tile,
/obj/structure/stone_tile{
	dir = 4
	},
/obj/structure/stone_tile{
	dir = 1
	},
/turf/open/lava/smooth/lava_land_surface{
	slowdown = 0
	},
/area/ruin/unpowered/marked_one_arena)
"GM" = (
/obj/structure/stone_tile/block{
	dir = 4
	},
/obj/structure/stone_tile{
	dir = 8
	},
/obj/structure/stone_tile{
	dir = 4
	},
/obj/item/card/id/green{
	desc = "A green card issued to temporary citizens of Nanotrasen-governed space, used to transfer between stations for work orders. This one's over fifty years out of date.";
	name = "station transfer card"
	},
/turf/open/lava/smooth/lava_land_surface{
	slowdown = 0
	},
/area/ruin/unpowered/marked_one_arena)
"GU" = (
/obj/structure/stone_tile/block{
	dir = 1
	},
/obj/structure/stone_tile,
/obj/structure/stone_tile{
	dir = 8
	},
/turf/open/indestructible/boss,
/area/ruin/unpowered/marked_one_arena)
"Ir" = (
/obj/effect/mob_spawn/corpse/human/damaged/ashwalker,
/turf/open/misc/asteroid/basalt/lava_land_surface,
/area/lavaland/surface/outdoors)
"Iv" = (
/obj/structure/stone_tile/block,
/obj/structure/stone_tile/block{
	dir = 1
	},
/turf/open/lava/smooth/lava_land_surface{
	slowdown = 0
	},
/area/ruin/unpowered/marked_one_arena)
"Jk" = (
/obj/structure/stone_tile/block{
	dir = 4
	},
/obj/structure/stone_tile{
	dir = 8
	},
/obj/structure/stone_tile{
	dir = 4
	},
/turf/open/indestructible/boss,
/area/lavaland/surface/outdoors)
"Jv" = (
/obj/structure/stone_tile/block{
	dir = 4
	},
/obj/structure/stone_tile{
	dir = 8
	},
/obj/structure/stone_tile{
	dir = 4
	},
/turf/open/indestructible/boss,
/area/ruin/unpowered/marked_one_arena)
"JC" = (
/obj/structure/stone_tile/surrounding_tile{
	dir = 4
	},
/obj/structure/stone_tile/surrounding_tile{
	dir = 8
	},
/obj/structure/stone_tile/center/burnt,
/turf/open/lava/smooth/lava_land_surface{
	slowdown = 0
	},
/area/ruin/unpowered/marked_one_arena)
"JM" = (
/obj/structure/stone_tile/block{
	dir = 8
	},
/turf/open/lava/smooth/lava_land_surface{
	slowdown = 0
	},
/area/ruin/unpowered/marked_one_arena)
"JS" = (
/obj/structure/stone_tile/slab/burnt,
/turf/open/lava/smooth/lava_land_surface{
	slowdown = 0
	},
/area/lavaland/surface/outdoors)
"Kc" = (
/obj/structure/stone_tile/slab,
/turf/open/lava/smooth/lava_land_surface{
	slowdown = 0
	},
/area/ruin/unpowered/marked_one_arena)
"LS" = (
/obj/structure/statue/bone/rib,
/turf/open/misc/asteroid/basalt/lava_land_surface,
/area/lavaland/surface/outdoors)
"MF" = (
/obj/structure/stone_tile/block{
	dir = 4
	},
/obj/structure/stone_tile{
	dir = 8
	},
/obj/structure/stone_tile{
	dir = 4
	},
/mob/living/basic/mining/hivelord/no_wander{
	color = "red";
	name = "gate guardian"
	},
/turf/open/indestructible/boss,
/area/ruin/unpowered/marked_one_arena)
"MP" = (
/obj/structure/stone_tile,
/obj/structure/stone_tile{
	dir = 8
	},
/obj/structure/stone_tile{
	dir = 4
	},
/obj/structure/stone_tile{
	dir = 1
	},
/obj/item/claymore/bone,
/turf/open/lava/smooth/lava_land_surface{
	slowdown = 0
	},
/area/ruin/unpowered/marked_one_arena)
"Ng" = (
/obj/structure/stone_tile/block{
	dir = 8
	},
/obj/structure/stone_tile{
	dir = 1
	},
/turf/open/lava/smooth/lava_land_surface{
	slowdown = 0
	},
/area/ruin/unpowered/marked_one_arena)
"No" = (
/obj/structure/stone_tile,
/obj/structure/stone_tile{
	dir = 8
	},
/obj/structure/stone_tile{
	dir = 4
	},
/obj/structure/stone_tile{
	dir = 1
	},
/obj/item/knife/combat/bone,
/turf/open/indestructible/boss,
/area/ruin/unpowered/marked_one_arena)
"ND" = (
/turf/template_noop,
/area/template_noop)
"Ov" = (
/obj/structure/stone_tile,
/obj/structure/stone_tile{
	dir = 1
	},
/turf/open/lava/smooth/lava_land_surface{
	slowdown = 0
	},
/area/ruin/unpowered/marked_one_arena)
"Pg" = (
/obj/structure/stone_tile{
	dir = 1
	},
/obj/structure/stone_tile{
	dir = 4
	},
/obj/structure/stone_tile{
	dir = 8
	},
/turf/open/lava/smooth/lava_land_surface{
	slowdown = 0
	},
/area/ruin/unpowered/marked_one_arena)
"Pj" = (
/obj/structure/stone_tile/block{
	dir = 4
	},
/obj/structure/stone_tile{
	dir = 4
	},
/obj/structure/stone_tile{
	dir = 8
	},
/turf/open/indestructible/boss,
/area/ruin/unpowered/marked_one_arena)
"PK" = (
/obj/structure/stone_tile/surrounding_tile{
	dir = 1
	},
/obj/structure/stone_tile/surrounding_tile,
/obj/structure/stone_tile/center,
/turf/open/lava/smooth/lava_land_surface{
	slowdown = 0
	},
/area/ruin/unpowered/marked_one_arena)
"PO" = (
/obj/structure/stone_tile,
/obj/structure/stone_tile{
	dir = 8
	},
/obj/structure/stone_tile{
	dir = 4
	},
/obj/structure/stone_tile{
	dir = 1
	},
/obj/item/fireaxe/boneaxe,
/turf/open/indestructible/boss,
/area/ruin/unpowered/marked_one_arena)
"Qe" = (
/obj/structure/stone_tile/block{
	dir = 8
	},
/obj/structure/stone_tile,
/obj/structure/stone_tile{
	dir = 1
	},
/turf/open/lava/smooth/lava_land_surface{
	slowdown = 0
	},
/area/ruin/unpowered/marked_one_arena)
"Qj" = (
/obj/structure/stone_tile/block{
	dir = 1
	},
/obj/structure/stone_tile,
/obj/structure/stone_tile{
	dir = 8
	},
/obj/effect/decal/remains/human{
	desc = "They look like remains, whether ash walker or miner you cannot tell. They have a strange aura about them."
	},
/obj/item/clothing/under/costume/gladiator/ash_walker,
/turf/open/lava/smooth/lava_land_surface{
	slowdown = 0
	},
/area/ruin/unpowered/marked_one_arena)
"Qs" = (
/obj/structure/stone_tile/slab,
/obj/effect/gibspawner/human,
/obj/item/clothing/suit/hooded/explorer,
/turf/open/indestructible/boss,
/area/ruin/unpowered/marked_one_arena)
"RQ" = (
/obj/structure/stone_tile/slab/cracked,
/turf/open/indestructible/boss,
/area/ruin/unpowered/marked_one_arena)
"So" = (
/obj/structure/stone_tile,
/obj/structure/stone_tile{
	dir = 8
	},
/obj/structure/stone_tile{
	dir = 4
	},
/obj/structure/stone_tile{
	dir = 1
	},
/obj/item/clothing/under/costume/gladiator,
/turf/open/indestructible/boss,
/area/ruin/unpowered/marked_one_arena)
"Tf" = (
/turf/open/misc/asteroid/basalt/lava_land_surface,
/area/lavaland/surface/outdoors)
"Tu" = (
/obj/structure/stone_tile/block{
	dir = 4
	},
/turf/open/lava/smooth/lava_land_surface{
	slowdown = 0
	},
/area/ruin/unpowered/marked_one_arena)
"TP" = (
/obj/structure/stone_tile/block,
/obj/structure/stone_tile{
	dir = 4
	},
/obj/structure/stone_tile{
	dir = 1
	},
/turf/open/indestructible/boss,
/area/ruin/unpowered/marked_one_arena)
"UM" = (
/obj/structure/stone_tile{
	dir = 8
	},
/obj/structure/stone_tile{
	dir = 1
	},
/obj/structure/stone_tile,
/obj/structure/stone_tile/cracked{
	dir = 4
	},
/turf/open/lava/smooth/lava_land_surface{
	slowdown = 0
	},
/area/ruin/unpowered/marked_one_arena)
"VU" = (
/obj/structure/stone_tile/slab/burnt,
/turf/open/lava/smooth/lava_land_surface{
	slowdown = 0
	},
/area/ruin/unpowered/marked_one_arena)
"Wc" = (
/obj/structure/stone_tile{
	dir = 8
	},
/obj/structure/stone_tile{
	dir = 1
	},
/turf/open/lava/smooth/lava_land_surface{
	slowdown = 0
	},
/area/ruin/unpowered/marked_one_arena)
"Wr" = (
/obj/structure/stone_tile/slab,
/turf/open/indestructible/boss,
/area/ruin/unpowered/marked_one_arena)
"WD" = (
/obj/structure/stone_tile,
/obj/structure/stone_tile{
	dir = 4
	},
/obj/structure/stone_tile/cracked{
	dir = 8
	},
/turf/open/lava/smooth/lava_land_surface{
	slowdown = 0
	},
/area/ruin/unpowered/marked_one_arena)
"WF" = (
/obj/structure/stone_tile/slab/cracked,
/turf/open/lava/smooth/lava_land_surface{
	slowdown = 0
	},
/area/ruin/unpowered/marked_one_arena)
"WK" = (
/obj/structure/stone_tile/block{
	dir = 4
	},
/obj/structure/stone_tile{
	dir = 8
	},
/turf/open/lava/smooth/lava_land_surface{
	slowdown = 0
	},
/area/ruin/unpowered/marked_one_arena)
"XL" = (
/obj/structure/stone_tile,
/obj/structure/stone_tile{
	dir = 8
	},
/obj/structure/stone_tile{
	dir = 4
	},
/obj/structure/stone_tile{
	dir = 1
	},
/turf/open/indestructible/boss,
/area/ruin/unpowered/marked_one_arena)
"XY" = (
/turf/closed/indestructible/riveted/boss,
/area/lavaland/surface/outdoors)
"YA" = (
/obj/structure/stone_tile,
/obj/structure/stone_tile{
	dir = 8
	},
/obj/structure/stone_tile{
	dir = 4
	},
/obj/structure/stone_tile{
	dir = 1
	},
/obj/item/paper/crumpled/bloody{
	color = "#D2B48C";
	default_raw_text = "why me goddammit why me why did that fucking tomb do this to me where are the others";
	text = null
	},
/turf/open/indestructible/boss,
/area/ruin/unpowered/marked_one_arena)
"Za" = (
/obj/structure/stone_tile{
	dir = 4
	},
/obj/structure/stone_tile,
/turf/open/lava/smooth/lava_land_surface{
	slowdown = 0
	},
/area/ruin/unpowered/marked_one_arena)

(1,1,1) = {"
ND
ND
ND
ND
ND
ND
ND
ND
XY
XY
Tf
Tf
Tf
ND
ND
ND
Tf
Tf
Tf
Tf
Tf
XY
XY
Tf
ND
ND
ND
ND
ND
ND
ND
"}
(2,1,1) = {"
ND
ND
ND
ND
ND
ND
Tf
Tf
XY
XY
Tf
Tf
gJ
Tf
Tf
gJ
Tf
Tf
gJ
Tf
Tf
XY
XY
Tf
Tf
Tf
ND
ND
ND
ND
ND
"}
(3,1,1) = {"
ND
ND
XY
XY
Tf
Tf
Tf
Tf
Tf
Tf
Tf
gJ
gJ
gJ
gJ
gJ
gJ
gJ
gJ
gJ
Tf
Tf
Tf
Tf
Tf
Tf
Tf
XY
XY
ND
ND
"}
(4,1,1) = {"
ND
ND
XY
XY
Tf
Tf
Tf
Tf
gJ
gJ
gJ
gJ
Wr
Kc
Wr
Fg
Wr
WF
Wr
gJ
gJ
gJ
gJ
Tf
Tf
Tf
Tf
XY
XY
ND
ND
"}
(5,1,1) = {"
ND
ND
Tf
Tf
Tf
Tf
gJ
gJ
gJ
Wr
BX
Wr
XL
CJ
Wr
Iv
Wr
xh
XL
Wr
Wr
Wr
gJ
gJ
gJ
Tf
Tf
Tf
Tf
ND
ND
"}
(6,1,1) = {"
ND
ND
Tf
Tf
Tf
gJ
gJ
Wr
ga
pF
ne
ne
pF
CJ
Kc
PK
VU
xh
pF
ne
ne
pF
BX
ot
gJ
gJ
Tf
Tf
Tf
Tf
ND
"}
(7,1,1) = {"
ND
Tf
Tf
Tf
gJ
gJ
Wr
XL
XL
ie
gJ
gJ
CR
kO
Wr
WF
Qs
TP
Qj
gJ
gJ
xh
cA
XL
Wr
gJ
gJ
Tf
Tf
Tf
ND
"}
(8,1,1) = {"
ND
Tf
Tf
Tf
gJ
Wr
XL
XL
XL
ie
gJ
gJ
CR
kO
Wr
Kc
Wr
TP
qU
gJ
gJ
xh
XL
XL
XL
Wr
gJ
Tf
Tf
Tf
Tf
"}
(9,1,1) = {"
XY
XY
Tf
gJ
gJ
RQ
XL
XL
XL
pF
lf
lf
MP
kO
Wr
Kc
Wr
TP
pF
lf
lf
pF
XL
XL
So
RQ
gJ
gJ
Tf
XY
XY
"}
(10,1,1) = {"
XY
XY
Tf
gJ
si
pF
ne
ne
pF
XL
XL
xn
Wr
RQ
Wr
Kc
Wr
Wr
Wr
pF
XL
XL
pF
ne
ne
pF
Wr
gJ
Tf
XY
XY
"}
(11,1,1) = {"
Tf
Tf
Tf
gJ
up
ie
gJ
gJ
xh
XL
XL
WF
Wr
Wr
Wr
Kc
Wr
Wr
Wr
Kc
XL
XL
ie
gJ
gJ
xh
Wr
gJ
bm
Tf
Tf
"}
(12,1,1) = {"
ND
Tf
gJ
gJ
Wr
ie
gJ
gJ
xh
pF
Kc
Kc
VU
CJ
Kc
Kc
VU
xh
VU
Kc
Kc
pF
ie
gJ
gJ
xh
Wr
gJ
Ir
xF
Tf
"}
(13,1,1) = {"
ND
gJ
gJ
Wr
XL
pF
DM
lf
pF
Wr
Wr
Kc
XL
sL
Wr
Kc
Wr
sL
XL
Kc
Wr
Wr
pF
lf
lf
gJ
gJ
gJ
gJ
lJ
Tf
"}
(14,1,1) = {"
Tf
Tf
gJ
Kc
ne
lT
sL
sL
sL
RQ
Wr
Qe
GU
Tu
nc
WF
WK
Tu
TP
ne
Wr
Wr
sL
sL
sL
gJ
nA
DE
gJ
Tf
lJ
"}
(15,1,1) = {"
Tf
Tf
gJ
Wr
Wr
Kc
BX
Wr
Wr
Wr
Wr
lH
Za
vw
WD
Ov
Pg
pJ
Wc
DN
Wr
Wr
Wr
Wr
Wr
gJ
BX
Wr
ug
vF
vF
"}
(16,1,1) = {"
Tf
gJ
gJ
uv
uv
hN
Kc
Kc
WF
Kc
Kc
Kc
pF
pF
pF
ar
pF
pF
FE
Kc
Kc
Kc
WF
Kc
Kc
Dc
Kc
pM
Kc
JS
wQ
"}
(17,1,1) = {"
Tf
Tf
gJ
Wr
Wr
VU
Wr
Wr
RQ
Wr
Wr
bZ
Wc
UM
oW
ba
ly
jg
uM
vL
Wr
Wr
Wr
Wr
Wr
gJ
Wr
RQ
Jv
Jk
Jk
"}
(18,1,1) = {"
ND
Tf
gJ
Kc
dR
dR
Pj
Pj
Pj
Wr
BX
lf
kO
JM
Ng
Kc
al
JM
TP
dR
Wr
Wr
Pj
Pj
Pj
gJ
ey
MF
gJ
Tf
LS
"}
(19,1,1) = {"
Tf
gJ
gJ
Wr
XL
pF
ne
ne
pF
Wr
Wr
Kc
XL
Jv
Wr
Kc
Wr
Pj
XL
Kc
Wr
Wr
mZ
CK
ne
gJ
gJ
gJ
gJ
LS
Tf
"}
(20,1,1) = {"
Tf
Tf
gJ
gJ
ii
ie
gJ
gJ
xh
pF
Kc
cN
Kc
ie
Kc
VU
Kc
CR
Kc
Kc
WF
pF
ie
gJ
gJ
xh
Wr
XY
Tf
Tf
Tf
"}
(21,1,1) = {"
Tf
Tf
Tf
gJ
Wr
ie
gJ
gJ
xh
XL
XL
Kc
Wr
Wr
Wr
Kc
Wr
Wr
Wr
Kc
bc
XL
ie
gJ
gJ
xh
Aw
XY
Tf
Tf
Tf
"}
(22,1,1) = {"
XY
XY
Tf
gJ
Wr
pF
lf
lf
pF
XL
XL
pF
Wr
Wr
BX
Kc
RQ
Wr
Wr
pF
XL
YA
pF
lf
lf
pF
Wr
XY
Tf
XY
XY
"}
(23,1,1) = {"
XY
XY
Tf
gJ
gJ
Wr
XL
Df
XL
pF
ne
ne
pF
kO
Wr
Kc
Wr
TP
pF
ne
ne
pF
XL
XL
XL
Wr
gJ
XY
Tf
XY
XY
"}
(24,1,1) = {"
ND
Tf
Tf
Tf
gJ
Wr
XL
XL
PO
ie
gJ
gJ
xh
kO
Wr
Kc
Wr
TP
ie
gJ
gJ
xh
XL
XL
No
ot
gJ
Tf
Tf
Tf
Tf
"}
(25,1,1) = {"
ND
ND
Tf
Tf
gJ
gJ
Wr
XL
XL
ie
gJ
gJ
xh
kO
Wr
Kc
Wr
TP
ie
gJ
gJ
xh
XL
XL
Wr
gJ
gJ
Tf
Tf
Tf
Tf
"}
(26,1,1) = {"
ND
ND
Tf
Tf
Tf
gJ
gJ
BX
Wr
pF
GM
lf
pF
CJ
VU
JC
Kc
xh
ia
lf
lf
pF
RQ
Wr
gJ
gJ
Tf
Tf
Tf
Tf
ND
"}
(27,1,1) = {"
ND
ND
Tf
Tf
Tf
Tf
gJ
gJ
gJ
Wr
Wr
Wr
XL
CJ
Wr
xt
Wr
xh
xc
Aw
Wr
Wr
gJ
gJ
gJ
Tf
Tf
Tf
Tf
ND
ND
"}
(28,1,1) = {"
ND
ND
XY
XY
Tf
Tf
Tf
Tf
gJ
gJ
gJ
gJ
Wr
WF
Wr
xt
Wr
Kc
Wr
gJ
gJ
gJ
gJ
Tf
Tf
Tf
Tf
XY
XY
ND
ND
"}
(29,1,1) = {"
ND
ND
XY
XY
ND
Tf
tJ
Tf
Tf
Tf
Tf
gJ
gJ
gJ
gJ
gJ
gJ
gJ
gJ
gJ
Tf
Tf
Tf
Tf
Tf
Tf
Tf
XY
XY
ND
ND
"}
(30,1,1) = {"
ND
ND
ND
ND
ND
ND
Tf
Tf
XY
XY
Tf
Tf
gJ
Tf
Tf
gJ
Tf
Tf
gJ
Tf
Tf
XY
XY
Tf
Tf
ND
ND
ND
ND
ND
ND
"}
(31,1,1) = {"
ND
ND
ND
ND
ND
ND
ND
ND
XY
XY
Tf
ND
ND
Tf
Tf
Tf
ND
ND
ND
ND
Tf
XY
XY
ND
ND
ND
ND
ND
ND
ND
ND
"}
