//MAP CONVERTED BY dmm2tgm.py THIS HEADER COMMENT PREVENTS RECONVERSION, DO NOT REMOVE
"ag" = (
/obj/structure/table/reinforced,
/obj/machinery/door/firedoor,
/obj/machinery/chem_dispenser/drinks{
	dir = 8
	},
/turf/open/floor/iron/white,
/area/station/security/prison/mess)
"co" = (
/obj/effect/turf_decal/trimline/green/filled/line{
	dir = 4
	},
/obj/machinery/airalarm/directional/east,
/obj/structure/sink/kitchen/directional/west,
/turf/open/floor/iron,
/area/station/security/prison/garden)
"eL" = (
/obj/effect/turf_decal/tile/red/opposingcorners,
/obj/machinery/atmospherics/components/unary/vent_pump/on/layer4{
	dir = 4
	},
/obj/machinery/light_switch/directional/south,
/turf/open/floor/iron/white,
/area/station/security/prison/mess)
"fa" = (
/obj/structure/table/reinforced,
/obj/machinery/door/firedoor,
/turf/open/floor/iron/white,
/area/station/security/prison/mess)
"fz" = (
/obj/machinery/hydroponics/soil,
/obj/effect/decal/cleanable/dirt,
/turf/open/floor/grass,
/area/station/security/prison/garden)
"fE" = (
/obj/machinery/hydroponics/constructable,
/obj/effect/decal/cleanable/dirt,
/turf/open/floor/grass,
/area/station/security/prison/garden)
"gj" = (
/obj/effect/turf_decal/trimline/green/filled/line{
	dir = 1
	},
/obj/structure/reagent_dispensers/watertank/high,
/obj/item/reagent_containers/cup/watering_can,
/obj/item/reagent_containers/cup/watering_can{
	pixel_x = 7;
	pixel_y = 5
	},
/turf/open/floor/iron,
/area/station/security/prison/garden)
"gu" = (
/obj/structure/cable,
/obj/machinery/power/apc/auto_name/directional/south,
/turf/open/floor/iron,
/area/station/security/prison)
"iR" = (
/obj/structure/table/reinforced,
/obj/machinery/door/firedoor,
/obj/item/reagent_containers/condiment/peppermill{
	pixel_x = -7
	},
/obj/item/reagent_containers/condiment/saltshaker,
/turf/open/floor/iron/white,
/area/station/security/prison/mess)
"jk" = (
/obj/effect/turf_decal/trimline/red/filled/line{
	dir = 8
	},
/obj/machinery/atmospherics/pipe/smart/manifold4w/supply/hidden/layer4,
/obj/machinery/atmospherics/pipe/smart/manifold4w/scrubbers/hidden/layer2,
/obj/structure/cable,
/turf/open/floor/iron/white,
/area/station/security/prison)
"kT" = (
/obj/effect/turf_decal/tile/red/opposingcorners,
/obj/machinery/camera/directional/west{
	c_tag = "Prison Cafeteria";
	network = list("ss13","prison")
	},
/obj/structure/table/reinforced,
/obj/item/storage/fancy/egg_box,
/obj/item/reagent_containers/condiment/flour{
	pixel_x = -7;
	pixel_y = 4
	},
/obj/item/reagent_containers/condiment/sugar{
	pixel_x = 7;
	pixel_y = 4
	},
/obj/machinery/power/apc/auto_name/directional/west,
/obj/structure/cable,
/turf/open/floor/iron/white,
/area/station/security/prison/mess)
"lk" = (
/obj/machinery/light/directional/west,
/obj/effect/turf_decal/trimline/red/filled/line{
	dir = 9
	},
/obj/machinery/firealarm/directional/west,
/turf/open/floor/iron/white,
/area/station/security/prison)
"lI" = (
/obj/structure/cable,
/obj/effect/turf_decal/trimline/green/filled/corner{
	dir = 4
	},
/turf/open/floor/iron,
/area/station/security/prison/garden)
"me" = (
/obj/effect/turf_decal/trimline/green/filled/line{
	dir = 5
	},
/obj/structure/closet/crate/hydroponics,
/obj/effect/spawner/random/food_or_drink/seed{
	spawn_all_loot = 1;
	spawn_random_offset = 1
	},
/obj/item/paper/guides/jobs/hydroponics,
/obj/effect/spawner/random/contraband/prison,
/turf/open/floor/iron,
/area/station/security/prison/garden)
"oE" = (
/obj/machinery/chem_master/condimaster{
	name = "CondiMaster Neo"
	},
/obj/effect/turf_decal/bot,
/turf/open/floor/iron/white,
/area/station/security/prison/mess)
"pd" = (
/obj/machinery/biogenerator,
/obj/effect/turf_decal/bot,
/turf/open/floor/iron,
/area/station/security/prison/garden)
"rg" = (
/turf/closed/wall/r_wall,
/area/station/security/prison/garden)
"rM" = (
/obj/effect/turf_decal/tile/red/opposingcorners,
/obj/machinery/atmospherics/pipe/smart/manifold4w/supply/hidden/layer4,
/turf/open/floor/iron/white,
/area/station/security/prison/mess)
"sL" = (
/obj/structure/lattice,
/turf/open/space/basic,
/area/space/nearstation)
"sN" = (
/obj/effect/turf_decal/trimline/red/filled/line{
	dir = 8
	},
/turf/open/floor/iron/white,
/area/station/security/prison)
"tU" = (
/obj/structure/table/reinforced,
/obj/machinery/door/firedoor,
/obj/machinery/reagentgrinder{
	pixel_x = -4;
	pixel_y = 8
	},
/turf/open/floor/iron/white,
/area/station/security/prison/mess)
"um" = (
/obj/machinery/seed_extractor,
/obj/structure/cable,
/obj/effect/turf_decal/bot,
/turf/open/floor/iron,
/area/station/security/prison/garden)
"vt" = (
/obj/machinery/hydroponics/soil,
/obj/effect/decal/cleanable/dirt,
/obj/item/shovel/spade,
/obj/item/shovel/spade{
	pixel_x = -5;
	pixel_y = -4
	},
/turf/open/floor/grass,
/area/station/security/prison/garden)
"yi" = (
/obj/machinery/vending/hydroseeds{
	slogan_delay = 700
	},
/obj/effect/turf_decal/bot,
/turf/open/floor/iron,
/area/station/security/prison/garden)
"yQ" = (
/obj/effect/turf_decal/tile/red/opposingcorners,
/obj/structure/cable,
/obj/machinery/atmospherics/pipe/smart/manifold4w/supply/hidden/layer4,
/obj/machinery/atmospherics/pipe/smart/manifold4w/scrubbers/hidden/layer2,
/turf/open/floor/iron/white,
/area/station/security/prison/mess)
"AG" = (
/obj/effect/turf_decal/tile/red/opposingcorners,
/obj/machinery/smartfridge/drying,
/obj/effect/turf_decal/bot,
/turf/open/floor/iron/white,
/area/station/security/prison/mess)
"AQ" = (
/turf/open/space/basic,
/area/space)
"BA" = (
/obj/effect/turf_decal/tile/red/opposingcorners,
/obj/machinery/grill,
/obj/effect/turf_decal/bot,
/turf/open/floor/iron/white,
/area/station/security/prison/mess)
"BS" = (
/obj/structure/sink/kitchen/directional/south,
/obj/effect/turf_decal/tile/red/opposingcorners,
/turf/open/floor/iron/white,
/area/station/security/prison/mess)
"Cv" = (
/obj/effect/turf_decal/trimline/green/filled/line{
	dir = 4
	},
/obj/item/cultivator,
/obj/item/cultivator{
	pixel_x = -5;
	pixel_y = -2
	},
/turf/open/floor/iron,
/area/station/security/prison/garden)
"DU" = (
/obj/machinery/hydroponics/constructable,
/obj/effect/decal/cleanable/dirt,
/obj/structure/cable,
/turf/open/floor/grass,
/area/station/security/prison/garden)
"Eg" = (
/obj/effect/turf_decal/trimline/green/filled/line{
	dir = 9
	},
/obj/structure/cable,
/obj/item/plant_analyzer,
/obj/item/plant_analyzer{
	pixel_x = -4;
	pixel_y = -8
	},
/turf/open/floor/iron,
/area/station/security/prison/garden)
"Ei" = (
/obj/effect/turf_decal/tile/red/opposingcorners,
/obj/machinery/griddle,
/obj/effect/turf_decal/bot,
/turf/open/floor/iron/white,
/area/station/security/prison/mess)
"Es" = (
/obj/machinery/smartfridge,
/turf/open/floor/iron/white,
/area/station/security/prison/mess)
"EC" = (
/obj/effect/turf_decal/tile/red/opposingcorners,
/obj/structure/table/reinforced,
/obj/item/book/manual/chef_recipes,
/obj/item/reagent_containers/condiment/enzyme{
	pixel_x = 9;
	pixel_y = 3
	},
/turf/open/floor/iron/white,
/area/station/security/prison/mess)
"ER" = (
/obj/effect/turf_decal/tile/red/opposingcorners,
/obj/machinery/deepfryer,
/obj/effect/turf_decal/bot,
/turf/open/floor/iron/white,
/area/station/security/prison/mess)
"Hl" = (
/obj/item/radio/intercom/prison/directional/north,
/obj/machinery/light/directional/north,
/obj/effect/turf_decal/trimline/green/filled/line{
	dir = 1
	},
/obj/structure/cable,
/turf/open/floor/iron,
/area/station/security/prison/garden)
"HK" = (
/obj/effect/turf_decal/tile/red/opposingcorners,
/obj/structure/table/reinforced,
/obj/machinery/processor{
	pixel_y = 12
	},
/turf/open/floor/iron/white,
/area/station/security/prison/mess)
"IK" = (
/obj/effect/turf_decal/tile/red/opposingcorners,
/obj/machinery/atmospherics/components/unary/vent_scrubber/on/layer2,
/turf/open/floor/iron/white,
/area/station/security/prison/mess)
"Kf" = (
/obj/machinery/door/airlock/public{
	name = "Permabrig Kitchen"
	},
/obj/machinery/door/firedoor,
/obj/structure/cable,
/obj/machinery/atmospherics/pipe/smart/manifold4w/scrubbers/hidden/layer2,
/obj/machinery/atmospherics/pipe/smart/manifold4w/supply/hidden/layer4,
/turf/open/floor/iron/white,
/area/station/security/prison/mess)
"LJ" = (
/obj/effect/turf_decal/trimline/green/filled/line{
	dir = 8
	},
/obj/structure/cable,
/turf/open/floor/iron,
/area/station/security/prison/garden)
"Ns" = (
/obj/effect/turf_decal/tile/red/opposingcorners,
/turf/open/floor/iron/white,
/area/station/security/prison/mess)
"NV" = (
/obj/effect/turf_decal/tile/red/opposingcorners,
/obj/structure/cable,
/obj/structure/table/reinforced,
/obj/item/storage/bag/tray,
/obj/item/kitchen/rollingpin,
/obj/item/kitchen/rollingpin{
	pixel_x = 5
	},
/obj/machinery/airalarm/directional/west,
/obj/machinery/light/directional/west,
/turf/open/floor/iron/white,
/area/station/security/prison/mess)
"OV" = (
/obj/machinery/firealarm/directional/north,
/obj/machinery/oven/range,
/obj/effect/turf_decal/bot,
/obj/effect/turf_decal/tile/red/opposingcorners,
/turf/open/floor/iron/white,
/area/station/security/prison/mess)
"Po" = (
/obj/effect/spawner/structure/window/reinforced,
/obj/structure/cable,
/turf/open/floor/plating,
/area/station/security/prison/garden)
"Pw" = (
/obj/item/radio/intercom/prison/directional/north,
/obj/machinery/microwave,
/obj/structure/table,
/obj/effect/turf_decal/bot,
/obj/effect/turf_decal/tile/red/opposingcorners,
/turf/open/floor/iron/white,
/area/station/security/prison/mess)
"Rt" = (
/turf/template_noop,
/area/template_noop)
"Rv" = (
/obj/machinery/hydroponics/constructable,
/obj/effect/decal/cleanable/dirt,
/obj/machinery/light/small/directional/south,
/turf/open/floor/grass,
/area/station/security/prison/garden)
"TD" = (
/obj/effect/turf_decal/trimline/green/filled/line{
	dir = 4
	},
/obj/machinery/light/directional/east,
/turf/open/floor/iron,
/area/station/security/prison/garden)
"TP" = (
/turf/closed/wall,
/area/station/security/prison/mess)
"TS" = (
/obj/effect/turf_decal/tile/red/opposingcorners,
/obj/structure/cable,
/obj/machinery/atmospherics/pipe/smart/manifold4w/scrubbers/hidden/layer2,
/turf/open/floor/iron/white,
/area/station/security/prison/mess)
"WB" = (
/obj/structure/cable,
/obj/machinery/atmospherics/pipe/smart/manifold4w/supply/hidden/layer4,
/obj/effect/turf_decal/trimline/green/filled/line,
/turf/open/floor/iron,
/area/station/security/prison/garden)
"Xd" = (
/obj/effect/turf_decal/tile/red/opposingcorners,
/obj/structure/cable,
/turf/open/floor/iron/white,
/area/station/security/prison/mess)
"Yf" = (
/obj/structure/table/reinforced,
/obj/machinery/door/firedoor,
/obj/machinery/chem_dispenser/drinks/beer{
	dir = 8
	},
/turf/open/floor/iron/white,
/area/station/security/prison/mess)
"YL" = (
/obj/effect/turf_decal/trimline/green/filled/line{
	dir = 8
	},
/obj/structure/cable,
/obj/item/secateurs,
/obj/item/secateurs{
	pixel_x = -6;
	pixel_y = -3
	},
/turf/open/floor/iron,
/area/station/security/prison/garden)
"ZI" = (
/obj/effect/turf_decal/trimline/green/filled/line{
	dir = 4
	},
/obj/machinery/firealarm/directional/east,
/turf/open/floor/iron,
/area/station/security/prison/garden)
"ZV" = (
/turf/open/floor/iron,
/area/station/security/prison/garden)

(1,1,1) = {"
Rt
Rt
sL
Rt
rg
Po
Po
Rt
Rt
Rt
Rt
Rt
Rt
Rt
"}
(2,1,1) = {"
Rt
Rt
Rt
AQ
rg
yi
um
pd
fz
fz
Rt
vt
Rt
Rt
"}
(3,1,1) = {"
Rt
Rt
Rt
AQ
Po
Eg
YL
LJ
Rt
Rt
Rt
Rt
Rt
Rt
"}
(4,1,1) = {"
Rt
Rt
sL
sL
Po
gj
ZV
ZV
Rt
Rt
Rt
Rt
Rt
Rt
"}
(5,1,1) = {"
Rt
Rt
Rt
AQ
Po
me
TD
ZI
co
Cv
lI
Rt
Rv
Rt
"}
(6,1,1) = {"
Rt
Rt
Rt
Rt
Rt
Rt
Rt
Rt
Rt
Rt
Hl
WB
DU
Rt
"}
(7,1,1) = {"
Rt
Rt
Rt
oE
AG
Ei
kT
NV
HK
Rt
Rt
Rt
fE
Rt
"}
(8,1,1) = {"
Rt
BS
Ns
Ns
Ns
Ns
Ns
Xd
eL
Rt
Rt
Rt
Rt
Rt
"}
(9,1,1) = {"
Rt
OV
Ns
Ns
EC
ER
BA
Xd
rM
TP
Rt
Rt
Rt
Rt
"}
(10,1,1) = {"
Rt
Pw
Ns
Ns
Ns
Ns
IK
TS
yQ
Rt
Rt
Rt
Rt
Rt
"}
(11,1,1) = {"
TP
TP
tU
iR
fa
ag
Yf
Es
Kf
Rt
Rt
Rt
Rt
Rt
"}
(12,1,1) = {"
Rt
lk
sN
sN
sN
Rt
sN
Rt
jk
Rt
Rt
Rt
Rt
Rt
"}
(13,1,1) = {"
Rt
Rt
Rt
Rt
Rt
Rt
Rt
Rt
Rt
Rt
Rt
Rt
Rt
Rt
"}
(14,1,1) = {"
gu
Rt
Rt
Rt
Rt
Rt
Rt
Rt
Rt
Rt
Rt
Rt
Rt
Rt
"}
