//MAP CONVERTED BY dmm2tgm.py THIS HEADER COMMENT PREVENTS RECONVERSION, DO NOT REMOVE
"a" = (
/turf/template_noop,
/area/template_noop)
"b" = (
/obj/structure/lattice/catwalk,
/turf/open/space/basic,
/area/space/nearstation)
"d" = (
/obj/machinery/atmospherics/pipe/smart/manifold4w/scrubbers/hidden/layer2,
/obj/machinery/atmospherics/pipe/smart/manifold4w/cyan/hidden/layer4,
/obj/effect/turf_decal/stripes/line{
	dir = 4
	},
/turf/open/floor/engine,
/area/station/cargo/exploration_office)
"g" = (
/obj/structure/extinguisher_cabinet/directional/west,
/obj/machinery/firealarm/directional/south,
/obj/effect/turf_decal/stripes/line{
	dir = 10
	},
/turf/open/floor/engine,
/area/station/cargo/exploration_office)
"k" = (
/obj/structure/lattice/catwalk,
/obj/structure/marker_beacon/indigo{
	pixel_x = 14;
	pixel_y = -12
	},
/turf/open/space/basic,
/area/space/nearstation)
"n" = (
/turf/closed/wall,
/area/station/maintenance/port/fore)
"o" = (
/obj/structure/lattice/catwalk,
/obj/structure/railing{
	dir = 4
	},
/obj/structure/marker_beacon/indigo{
	pixel_x = -12;
	pixel_y = -12
	},
/turf/open/space/basic,
/area/space/nearstation)
"p" = (
/obj/structure/lattice/catwalk,
/obj/structure/sign/warning/directional/south,
/obj/structure/railing{
	dir = 1
	},
/turf/open/space/basic,
/area/space/nearstation)
"q" = (
/obj/machinery/atmospherics/pipe/smart/manifold4w/scrubbers/hidden/layer2,
/obj/machinery/atmospherics/pipe/smart/manifold4w/cyan/hidden/layer4,
/obj/effect/mapping_helpers/airlock/access/all/command/gateway,
/obj/effect/turf_decal/stripes/end,
/obj/effect/mapping_helpers/airlock/cyclelink_helper{
	dir = 1
	},
/obj/machinery/door/airlock/external/glass{
	name = "Exploration Office Airlock"
	},
/turf/open/floor/plating,
/area/station/cargo/exploration_office)
"r" = (
/obj/structure/cable,
/obj/machinery/atmospherics/components/unary/vent_pump/on/layer4{
	dir = 4
	},
/turf/open/floor/iron/smooth_large,
/area/station/cargo/exploration_office)
"s" = (
/obj/effect/spawner/structure/window/reinforced,
/turf/open/floor/plating,
/area/station/cargo/exploration_office)
"t" = (
/obj/machinery/light/directional/west,
/obj/machinery/atmospherics/components/unary/vent_scrubber/on/layer2{
	dir = 1
	},
/obj/effect/turf_decal/stripes/line{
	dir = 8
	},
/obj/item/radio/intercom/chapel/directional/west,
/obj/effect/landmark/start/explorer,
/turf/open/floor/engine,
/area/station/cargo/exploration_office)
"v" = (
/obj/machinery/atmospherics/components/unary/airlock_pump/unbolt_only,
/obj/effect/turf_decal/stripes/line{
	dir = 4
	},
/obj/effect/turf_decal/stripes/line{
	dir = 8
	},
/obj/machinery/light/small/directional/east,
/obj/structure/sign/warning/vacuum/external/directional/east,
/turf/open/floor/plating,
/area/station/cargo/exploration_office)
"w" = (
/obj/machinery/atmospherics/pipe/smart/manifold4w/scrubbers/hidden/layer2,
/obj/machinery/atmospherics/pipe/smart/manifold4w/cyan/hidden/layer4,
/obj/effect/turf_decal/stripes/line{
	dir = 9
	},
/obj/structure/closet/generic/wall/empty{
	pixel_x = -25
	},
/obj/item/multitool{
	pixel_x = -7;
	pixel_y = 2
	},
/obj/item/stack/impure_telecrystal{
	pixel_x = -6;
	pixel_y = -2
	},
/obj/item/stack/rods/twentyfive{
	pixel_x = 4
	},
/turf/open/floor/engine,
/area/station/cargo/exploration_office)
"x" = (
/obj/structure/cable,
/obj/machinery/airalarm/directional/east,
/obj/effect/spawner/random/engineering/tracking_beacon,
/turf/open/floor/iron/smooth_large,
/area/station/cargo/exploration_office)
"z" = (
/obj/structure/cable,
/obj/effect/landmark/start/explorer,
/obj/structure/chair/office{
	dir = 8
	},
/turf/open/floor/iron/smooth_large,
/area/station/cargo/exploration_office)
"A" = (
/obj/structure/cable,
/obj/machinery/power/apc/auto_name/directional/north,
/obj/machinery/atmospherics/pipe/smart/manifold4w/scrubbers/hidden/layer2,
/obj/machinery/atmospherics/pipe/smart/manifold4w/cyan/hidden/layer4,
/obj/effect/turf_decal/stripes/line{
	dir = 1
	},
/obj/structure/table/reinforced,
/obj/machinery/cell_charger{
	pixel_x = 3;
	pixel_y = 6
	},
/obj/machinery/recharger{
	pixel_x = -9
	},
/turf/open/floor/engine,
/area/station/cargo/exploration_office)
"B" = (
/obj/machinery/camera/autoname/directional/west,
/obj/machinery/suit_storage_unit/explorer,
/obj/effect/turf_decal/bot,
/turf/open/floor/iron/smooth_large,
/area/station/cargo/exploration_office)
"C" = (
/obj/structure/cable,
/obj/machinery/door/airlock/mining{
	name = "Exploration Office"
	},
/obj/machinery/atmospherics/pipe/smart/manifold4w/supply/hidden/layer4,
/obj/effect/mapping_helpers/airlock/access/all/command/gateway,
/obj/machinery/door/firedoor,
/obj/effect/landmark/navigate_destination/exploration_office,
/turf/open/floor/plating,
/area/station/cargo/exploration_office)
"D" = (
/obj/structure/cable,
/obj/machinery/atmospherics/pipe/smart/manifold4w/scrubbers/hidden/layer2,
/obj/machinery/atmospherics/pipe/smart/manifold4w/cyan/hidden/layer4,
/obj/machinery/computer/anchor_controller{
	dir = 4
	},
/obj/effect/turf_decal/stripes/line{
	dir = 5
	},
/turf/open/floor/engine,
/area/station/cargo/exploration_office)
"E" = (
/obj/structure/lattice,
/turf/open/space/basic,
/area/space/nearstation)
"F" = (
/obj/structure/lattice/catwalk,
/obj/structure/railing/corner/end{
	dir = 8
	},
/turf/open/space/basic,
/area/space/nearstation)
"G" = (
/obj/machinery/atmospherics/pipe/smart/manifold4w/scrubbers/hidden/layer2,
/obj/machinery/atmospherics/pipe/smart/manifold4w/cyan/hidden/layer4,
/obj/structure/tank_dispenser/oxygen,
/obj/machinery/light/small/directional/south,
/turf/open/floor/iron/smooth_large,
/area/station/cargo/exploration_office)
"H" = (
/obj/machinery/atmospherics/pipe/smart/manifold4w/scrubbers/hidden/layer2,
/obj/machinery/atmospherics/pipe/smart/manifold4w/cyan/hidden/layer4,
/obj/machinery/light/small/directional/east,
/turf/open/floor/plating,
/area/station/maintenance/port/fore)
"I" = (
/obj/machinery/atmospherics/pipe/smart/manifold4w/scrubbers/hidden/layer2,
/obj/machinery/atmospherics/pipe/smart/manifold4w/cyan/hidden/layer4,
/obj/effect/turf_decal/stripes/line{
	dir = 6
	},
/obj/effect/landmark/start/explorer,
/turf/open/floor/engine,
/area/station/cargo/exploration_office)
"J" = (
/obj/structure/lattice/catwalk,
/obj/structure/railing{
	dir = 1
	},
/turf/open/space/basic,
/area/space/nearstation)
"L" = (
/obj/structure/cable,
/obj/machinery/atmospherics/pipe/smart/manifold4w/supply/hidden/layer4,
/turf/open/floor/plating,
/area/station/maintenance/port/fore)
"O" = (
/obj/effect/mapping_helpers/airlock/access/all/command/gateway,
/obj/effect/mapping_helpers/airlock/cyclelink_helper,
/obj/effect/turf_decal/stripes/end{
	dir = 1
	},
/obj/machinery/door/airlock/external{
	name = "Exploration Office Airlock"
	},
/turf/open/floor/plating,
/area/station/cargo/exploration_office)
"P" = (
/turf/closed/wall,
/area/station/cargo/exploration_office)
"Q" = (
/obj/structure/lattice/catwalk,
/obj/structure/railing{
	dir = 4
	},
/turf/open/space/basic,
/area/space/nearstation)
"T" = (
/obj/machinery/dive_anchor,
/turf/open/space/basic,
/area/space/nearstation)
"U" = (
/obj/machinery/atmospherics/pipe/smart/manifold4w/scrubbers/hidden/layer2,
/obj/machinery/atmospherics/pipe/smart/manifold4w/cyan/hidden/layer4,
/turf/closed/wall,
/area/station/maintenance/port/fore)
"V" = (
/obj/effect/turf_decal/stripes/line,
/turf/open/floor/engine,
/area/station/cargo/exploration_office)
"X" = (
/obj/machinery/suit_storage_unit/explorer,
/obj/machinery/light_switch/directional/east,
/obj/effect/turf_decal/bot,
/turf/open/floor/iron/smooth_large,
/area/station/cargo/exploration_office)
"Y" = (
/obj/machinery/dive_anchor/stationary,
/obj/effect/turf_decal/stripes/box,
/turf/open/floor/engine,
/area/station/cargo/exploration_office)

(1,1,1) = {"
E
P
s
P
P
P
P
P
a
a
a
"}
(2,1,1) = {"
J
O
v
q
w
t
g
P
a
a
a
"}
(3,1,1) = {"
p
P
P
P
A
Y
V
B
a
a
a
"}
(4,1,1) = {"
J
k
b
s
D
d
I
G
U
H
a
"}
(5,1,1) = {"
F
b
T
s
z
x
r
X
a
a
a
"}
(6,1,1) = {"
a
o
Q
s
s
P
C
n
a
a
a
"}
(7,1,1) = {"
a
a
a
a
a
a
L
a
a
a
a
"}
