//MAP CONVERTED BY dmm2tgm.py THIS HEADER COMMENT PREVENTS RECONVERSION, DO NOT REMOVE
"a" = (
/turf/template_noop,
/area/template_noop)
"j" = (
/obj/structure/chair/stool/directional/east,
/obj/effect/turf_decal/stripes/line{
	dir = 4
	},
/obj/effect/landmark/start/explorer,
/turf/open/floor/iron,
/area/station/command/gateway)
"u" = (
/obj/effect/turf_decal/stripes/line{
	dir = 8
	},
/obj/structure/cable,
/obj/machinery/atmospherics/pipe/smart/manifold4w/scrubbers/hidden/layer2,
/obj/effect/landmark/start/explorer,
/turf/open/floor/iron,
/area/station/command/gateway)
"M" = (
/obj/effect/turf_decal/stripes/line{
	dir = 8
	},
/obj/structure/cable,
/obj/machinery/atmospherics/pipe/smart/manifold4w/supply/hidden/layer4,
/obj/machinery/atmospherics/pipe/smart/manifold4w/scrubbers/hidden/layer2,
/obj/effect/landmark/start/explorer,
/turf/open/floor/iron,
/area/station/command/gateway)

(1,1,1) = {"
M
a
u
"}
(2,1,1) = {"
a
j
a
"}
