//MAP CONVERTED BY dmm2tgm.py THIS HEADER COMMENT PREVENTS RECONVERSION, DO NOT REMOVE
"a" = (
/obj/machinery/computer/communications{
	dir = 8
	},
/obj/machinery/status_display/ai/directional/north,
/obj/machinery/keycard_auth/wall_mounted/directional/east,
/obj/structure/phone_base/captain{
	pixel_x = 38;
	pixel_y = 2
	},
/turf/open/floor/wood,
/area/station/command/heads_quarters/captain/private)

(1,1,1) = {"
a
"}
