//MAP CONVERTED BY dmm2tgm.py THIS HEADER COMMENT PREVENTS RECONVERSION, DO NOT REMOVE
"a" = (
/turf/template_noop,
/area/template_noop)
"b" = (
/obj/structure/cable,
/obj/machinery/light/small/directional/north,
/obj/machinery/atmospherics/components/unary/airlock_pump/unbolt_only,
/turf/open/floor/plating,
/area/station/cargo/miningoffice)
"d" = (
/obj/structure/cable,
/obj/machinery/atmospherics/components/unary/vent_pump/on/layer4{
	dir = 4
	},
/turf/open/floor/engine,
/area/station/cargo/miningoffice)
"e" = (
/obj/machinery/atmospherics/pipe/smart/manifold4w/scrubbers/hidden/layer2,
/obj/machinery/atmospherics/pipe/smart/manifold4w/cyan/hidden/layer4,
/turf/open/floor/engine,
/area/station/cargo/miningoffice)
"h" = (
/turf/open/floor/engine,
/area/station/cargo/miningoffice)
"j" = (
/obj/machinery/light/directional/west,
/obj/machinery/atmospherics/components/unary/vent_scrubber/on/layer2{
	dir = 1
	},
/turf/open/floor/engine,
/area/station/cargo/miningoffice)
"l" = (
/obj/machinery/suit_storage_unit/standard_unit,
/obj/machinery/atmospherics/pipe/smart/manifold4w/scrubbers/hidden/layer2,
/obj/machinery/atmospherics/pipe/smart/manifold4w/cyan/hidden/layer4,
/turf/open/floor/engine,
/area/station/cargo/miningoffice)
"n" = (
/obj/effect/spawner/structure/window/reinforced,
/turf/open/floor/plating,
/area/station/cargo/miningoffice)
"o" = (
/obj/machinery/atmospherics/pipe/smart/manifold4w/scrubbers/hidden/layer2,
/obj/machinery/atmospherics/pipe/smart/manifold4w/cyan/hidden/layer4,
/obj/effect/spawner/structure/window/reinforced,
/turf/open/floor/plating,
/area/template_noop)
"p" = (
/obj/machinery/suit_storage_unit/standard_unit,
/turf/open/floor/engine,
/area/station/cargo/miningoffice)
"s" = (
/obj/machinery/dive_anchor,
/turf/open/space/basic,
/area/space/nearstation)
"t" = (
/obj/structure/cable,
/obj/machinery/power/apc/auto_name/directional/north,
/obj/machinery/atmospherics/pipe/smart/manifold4w/scrubbers/hidden/layer2,
/obj/machinery/atmospherics/pipe/smart/manifold4w/cyan/hidden/layer4,
/turf/open/floor/engine,
/area/station/cargo/miningoffice)
"z" = (
/obj/structure/cable,
/obj/machinery/atmospherics/pipe/smart/manifold4w/scrubbers/hidden/layer2,
/obj/machinery/atmospherics/pipe/smart/manifold4w/cyan/hidden/layer4,
/turf/open/floor/engine,
/area/station/cargo/miningoffice)
"A" = (
/obj/structure/cable,
/obj/machinery/airalarm/directional/east,
/obj/structure/rack,
/obj/item/multitool,
/obj/item/stack/impure_telecrystal,
/turf/open/floor/engine,
/area/station/cargo/miningoffice)
"B" = (
/obj/structure/cable,
/obj/machinery/atmospherics/pipe/smart/manifold4w/scrubbers/hidden/layer2,
/obj/machinery/atmospherics/pipe/smart/manifold4w/cyan/hidden/layer4,
/obj/effect/mapping_helpers/airlock/access/any/supply/mining,
/obj/machinery/door/airlock/external{
	name = "Exploration Office Airlock";
	space_dir = 1
	},
/obj/effect/mapping_helpers/airlock/cyclelink_helper_multi{
	cycle_id = "exploration-office-airlock"
	},
/turf/open/floor/plating,
/area/station/cargo/miningoffice)
"D" = (
/obj/machinery/dive_anchor/stationary,
/turf/open/floor/engine,
/area/station/cargo/miningoffice)
"F" = (
/obj/machinery/camera/autoname/directional/west,
/obj/machinery/suit_storage_unit/standard_unit,
/turf/open/floor/engine,
/area/station/cargo/miningoffice)
"K" = (
/obj/machinery/atmospherics/pipe/smart/manifold4w/scrubbers/hidden/layer2,
/obj/machinery/atmospherics/pipe/smart/manifold4w/cyan/hidden/layer4,
/obj/machinery/light/small/directional/east,
/turf/open/floor/plating,
/area/template_noop)
"L" = (
/turf/closed/wall,
/area/station/cargo/miningoffice)
"M" = (
/obj/structure/cable,
/obj/machinery/door/airlock/mining{
	name = "Exploration Office"
	},
/obj/effect/mapping_helpers/airlock/access/any/supply/mining,
/obj/machinery/atmospherics/pipe/smart/manifold4w/supply/hidden/layer4,
/turf/open/floor/plating,
/area/station/cargo/miningoffice)
"O" = (
/obj/machinery/computer/anchor_controller{
	dir = 8
	},
/obj/structure/cable,
/turf/open/floor/engine,
/area/station/cargo/miningoffice)
"U" = (
/obj/structure/cable,
/obj/machinery/atmospherics/pipe/smart/manifold4w/supply/hidden/layer4,
/obj/structure/sign/warning/vacuum/external/directional/north,
/turf/open/floor/plating,
/area/template_noop)
"V" = (
/obj/structure/tank_dispenser/oxygen{
	pixel_x = -1
	},
/turf/open/floor/engine,
/area/station/cargo/miningoffice)
"Y" = (
/obj/structure/lattice/catwalk,
/turf/open/space/basic,
/area/space/nearstation)
"Z" = (
/obj/structure/cable,
/obj/effect/mapping_helpers/airlock/cyclelink_helper_multi{
	cycle_id = "exploration-office-airlock"
	},
/obj/effect/mapping_helpers/airlock/access/any/supply/mining,
/obj/machinery/door/airlock/external{
	name = "Exploration Office Airlock";
	space_dir = 1
	},
/turf/open/floor/plating,
/area/station/cargo/miningoffice)

(1,1,1) = {"
L
L
L
L
L
L
L
a
a
a
"}
(2,1,1) = {"
L
b
B
z
j
V
L
a
a
a
"}
(3,1,1) = {"
L
Z
L
t
D
h
F
a
a
a
"}
(4,1,1) = {"
Y
Y
n
z
e
e
l
o
K
a
"}
(5,1,1) = {"
Y
s
n
O
A
d
p
a
a
a
"}
(6,1,1) = {"
Y
Y
L
L
L
M
a
a
a
a
"}
(7,1,1) = {"
a
a
a
a
a
U
a
a
a
a
"}
