//MAP CONVERTED BY dmm2tgm.py THIS HEADER COMMENT PREVENTS RECONVERSION, DO NOT REMOVE
"a" = (
/turf/template_noop,
/area/template_noop)
"b" = (
/obj/structure/lattice/catwalk,
/turf/open/space/basic,
/area/space/nearstation)
"d" = (
/obj/machinery/atmospherics/pipe/smart/manifold4w/scrubbers/hidden/layer2,
/obj/machinery/atmospherics/pipe/smart/manifold4w/cyan/hidden/layer4,
/turf/open/floor/engine,
/area/station/cargo/exploration_office)
"g" = (
/obj/structure/sign/poster/abductor/ayylian/directional/west,
/turf/open/floor/engine,
/area/station/cargo/exploration_office)
"q" = (
/obj/machinery/atmospherics/pipe/smart/manifold4w/scrubbers/hidden/layer2,
/obj/machinery/atmospherics/pipe/smart/manifold4w/cyan/hidden/layer4,
/obj/machinery/door/airlock/external{
	name = "Exploration Office Airlock";
	space_dir = 1
	},
/obj/effect/mapping_helpers/airlock/cyclelink_helper_multi{
	cycle_id = "exploration-office-airlock"
	},
/obj/effect/mapping_helpers/airlock/access/all/command/gateway,
/turf/open/floor/plating,
/area/station/cargo/exploration_office)
"r" = (
/obj/structure/cable,
/obj/machinery/atmospherics/components/unary/vent_pump/on/layer4{
	dir = 4
	},
/turf/open/floor/engine,
/area/station/cargo/exploration_office)
"s" = (
/obj/effect/spawner/structure/window/reinforced,
/turf/open/floor/plating,
/area/station/cargo/exploration_office)
"t" = (
/obj/machinery/light/directional/west,
/obj/machinery/atmospherics/components/unary/vent_scrubber/on/layer2{
	dir = 1
	},
/turf/open/floor/engine,
/area/station/cargo/exploration_office)
"v" = (
/obj/machinery/light/small/directional/north,
/obj/machinery/atmospherics/components/unary/airlock_pump/unbolt_only,
/turf/open/floor/plating,
/area/station/cargo/exploration_office)
"w" = (
/obj/machinery/atmospherics/pipe/smart/manifold4w/scrubbers/hidden/layer2,
/obj/machinery/atmospherics/pipe/smart/manifold4w/cyan/hidden/layer4,
/obj/effect/landmark/start/explorer,
/obj/item/radio/intercom/chapel/directional/west,
/turf/open/floor/engine,
/area/station/cargo/exploration_office)
"x" = (
/obj/structure/cable,
/obj/machinery/airalarm/directional/east,
/obj/structure/rack,
/obj/item/multitool,
/obj/item/stack/impure_telecrystal,
/turf/open/floor/engine,
/area/station/cargo/exploration_office)
"z" = (
/obj/machinery/computer/anchor_controller{
	dir = 8
	},
/obj/structure/cable,
/turf/open/floor/engine,
/area/station/cargo/exploration_office)
"A" = (
/obj/structure/cable,
/obj/machinery/power/apc/auto_name/directional/north,
/obj/machinery/atmospherics/pipe/smart/manifold4w/scrubbers/hidden/layer2,
/obj/machinery/atmospherics/pipe/smart/manifold4w/cyan/hidden/layer4,
/turf/open/floor/engine,
/area/station/cargo/exploration_office)
"B" = (
/obj/machinery/camera/autoname/directional/west,
/obj/machinery/suit_storage_unit/standard_unit,
/turf/open/floor/engine,
/area/station/cargo/exploration_office)
"C" = (
/obj/structure/cable,
/obj/machinery/door/airlock/mining{
	name = "Exploration Office"
	},
/obj/machinery/atmospherics/pipe/smart/manifold4w/supply/hidden/layer4,
/obj/effect/mapping_helpers/airlock/access/all/command/gateway,
/turf/open/floor/plating,
/area/station/cargo/exploration_office)
"D" = (
/obj/structure/cable,
/obj/machinery/atmospherics/pipe/smart/manifold4w/scrubbers/hidden/layer2,
/obj/machinery/atmospherics/pipe/smart/manifold4w/cyan/hidden/layer4,
/obj/effect/landmark/start/explorer,
/turf/open/floor/engine,
/area/station/cargo/exploration_office)
"G" = (
/obj/machinery/atmospherics/pipe/smart/manifold4w/scrubbers/hidden/layer2,
/obj/machinery/atmospherics/pipe/smart/manifold4w/cyan/hidden/layer4,
/obj/structure/tank_dispenser/oxygen,
/turf/open/floor/engine,
/area/station/cargo/exploration_office)
"H" = (
/obj/machinery/atmospherics/pipe/smart/manifold4w/scrubbers/hidden/layer2,
/obj/machinery/atmospherics/pipe/smart/manifold4w/cyan/hidden/layer4,
/obj/machinery/light/small/directional/east,
/turf/open/floor/plating,
/area/station/maintenance/port/fore)
"J" = (
/obj/effect/mapping_helpers/airlock/cyclelink_helper_multi{
	cycle_id = "exploration-office-airlock"
	},
/obj/machinery/door/airlock/external{
	name = "Exploration Office Airlock";
	space_dir = 1
	},
/obj/effect/mapping_helpers/airlock/access/all/command/gateway,
/turf/open/floor/plating,
/area/station/cargo/exploration_office)
"K" = (
/obj/structure/lattice/catwalk,
/obj/structure/sign/warning/vacuum/directional/west,
/turf/open/space/basic,
/area/space/nearstation)
"L" = (
/obj/structure/cable,
/obj/machinery/atmospherics/pipe/smart/manifold4w/supply/hidden/layer4,
/obj/structure/sign/warning/vacuum/external/directional/north,
/turf/open/floor/plating,
/area/station/maintenance/port/fore)
"M" = (
/obj/structure/lattice/catwalk,
/obj/structure/sign/warning/directional/south,
/turf/open/space/basic,
/area/space/nearstation)
"P" = (
/turf/closed/wall,
/area/station/cargo/exploration_office)
"T" = (
/obj/machinery/dive_anchor,
/turf/open/space/basic,
/area/space/nearstation)
"U" = (
/obj/machinery/atmospherics/pipe/smart/manifold4w/scrubbers/hidden/layer2,
/obj/machinery/atmospherics/pipe/smart/manifold4w/cyan/hidden/layer4,
/turf/closed/wall,
/area/station/maintenance/port/fore)
"V" = (
/obj/effect/landmark/start/explorer,
/turf/open/floor/engine,
/area/station/cargo/exploration_office)
"X" = (
/obj/machinery/suit_storage_unit/standard_unit,
/obj/machinery/light_switch/directional/east,
/turf/open/floor/engine,
/area/station/cargo/exploration_office)
"Y" = (
/obj/machinery/dive_anchor/stationary,
/turf/open/floor/engine,
/area/station/cargo/exploration_office)

(1,1,1) = {"
P
s
P
P
P
P
P
a
a
a
"}
(2,1,1) = {"
P
v
q
w
t
g
P
a
a
a
"}
(3,1,1) = {"
P
J
P
A
Y
V
B
a
a
a
"}
(4,1,1) = {"
K
b
s
D
d
d
G
U
H
a
"}
(5,1,1) = {"
b
T
s
z
x
r
X
a
a
a
"}
(6,1,1) = {"
b
M
P
s
P
C
a
a
a
a
"}
(7,1,1) = {"
a
a
a
a
a
L
a
a
a
a
"}
