//MAP CONVERTED BY dmm2tgm.py THIS HEADER COMMENT PREVENTS RECONVERSION, DO NOT REMOVE
"a" = (
/obj/structure/reagent_dispensers/cooking_oil,
/obj/effect/turf_decal/tile/dark_green/opposingcorners,
/obj/effect/turf_decal/tile/dark_blue/opposingcorners{
	dir = 1
	},
/turf/open/floor/iron/kitchen_coldroom,
/area/station/service/kitchen/coldroom)
"b" = (
/obj/machinery/atmospherics/pipe/smart/manifold4w/supply/hidden/layer4,
/obj/machinery/light/small/directional/north,
/obj/machinery/atmospherics/pipe/smart/manifold4w/scrubbers/hidden/layer2,
/obj/structure/disposalpipe/segment{
	dir = 4
	},
/obj/effect/turf_decal/siding/white,
/turf/open/floor/iron/kitchen_coldroom/freezerfloor,
/area/station/service/kitchen/coldroom)
"f" = (
/obj/machinery/food_cart,
/obj/effect/turf_decal/siding/white{
	dir = 8
	},
/turf/open/floor/iron/kitchen_coldroom/freezerfloor,
/area/station/service/kitchen/coldroom)
"h" = (
/obj/machinery/atmospherics/pipe/smart/manifold4w/supply/hidden/layer4,
/obj/machinery/atmospherics/pipe/smart/manifold4w/scrubbers/hidden/layer2,
/obj/structure/cable,
/obj/structure/disposalpipe/segment{
	dir = 5
	},
/obj/effect/turf_decal/siding/white{
	dir = 8
	},
/turf/open/floor/iron/kitchen_coldroom/freezerfloor,
/area/station/service/kitchen/coldroom)
"o" = (
/obj/machinery/atmospherics/pipe/smart/manifold4w/supply/hidden/layer4,
/obj/machinery/atmospherics/components/unary/passive_vent{
	dir = 8
	},
/obj/structure/cable,
/obj/structure/disposalpipe/segment,
/obj/machinery/duct,
/obj/effect/decal/cleanable/dirt,
/obj/effect/turf_decal/siding/white{
	dir = 8
	},
/turf/open/floor/iron/kitchen_coldroom/freezerfloor,
/area/station/service/kitchen/coldroom)
"q" = (
/obj/machinery/atmospherics/pipe/smart/manifold4w/supply/hidden/layer4,
/obj/machinery/atmospherics/pipe/smart/manifold4w/scrubbers/hidden/layer2,
/obj/structure/cable,
/obj/structure/disposalpipe/segment{
	dir = 4
	},
/obj/effect/decal/cleanable/dirt,
/obj/effect/turf_decal/siding/white/corner,
/turf/open/floor/iron/kitchen_coldroom/freezerfloor,
/area/station/service/kitchen/coldroom)
"r" = (
/obj/machinery/gibber,
/obj/effect/turf_decal/tile/dark_green/opposingcorners,
/obj/effect/turf_decal/tile/dark_blue/opposingcorners{
	dir = 1
	},
/turf/open/floor/iron/kitchen_coldroom,
/area/station/service/kitchen/coldroom)
"s" = (
/obj/machinery/atmospherics/pipe/smart/manifold4w/supply/hidden/layer4,
/obj/structure/cable,
/obj/structure/fans/tiny,
/obj/structure/disposalpipe/segment,
/obj/machinery/duct,
/obj/machinery/door/airlock/freezer{
	name = "Coldroom"
	},
/obj/effect/mapping_helpers/airlock/access/all/service/kitchen,
/turf/open/floor/iron/kitchen_coldroom/freezerfloor,
/area/station/service/kitchen/coldroom)
"v" = (
/obj/machinery/atmospherics/components/unary/vent_pump/on/layer4{
	dir = 1
	},
/obj/structure/kitchenspike,
/obj/effect/turf_decal/tile/dark_green/opposingcorners,
/obj/effect/turf_decal/tile/dark_blue/opposingcorners{
	dir = 1
	},
/turf/open/floor/iron/kitchen_coldroom,
/area/station/service/kitchen/coldroom)
"w" = (
/obj/machinery/light_switch/directional/north,
/obj/structure/window/reinforced/spawner/directional/south,
/obj/machinery/atmospherics/components/unary/thermomachine/freezer/on/coldroom,
/obj/effect/turf_decal/delivery,
/obj/effect/turf_decal/tile/dark_green/opposingcorners,
/obj/effect/turf_decal/tile/dark_blue/opposingcorners{
	dir = 1
	},
/turf/open/floor/iron/kitchen_coldroom,
/area/station/service/kitchen/coldroom)
"y" = (
/obj/machinery/icecream_vat,
/obj/effect/turf_decal/siding/white{
	dir = 4
	},
/turf/open/floor/iron/kitchen_coldroom/freezerfloor,
/area/station/service/kitchen/coldroom)
"F" = (
/obj/machinery/atmospherics/components/unary/vent_scrubber/on/layer2{
	dir = 4
	},
/obj/machinery/light/small/directional/west,
/obj/machinery/camera/directional/west{
	c_tag = "Kitchen - Cold Room"
	},
/obj/structure/closet/secure_closet/freezer/meat,
/obj/effect/turf_decal/tile/dark_green/opposingcorners,
/obj/effect/turf_decal/tile/dark_blue/opposingcorners{
	dir = 1
	},
/turf/open/floor/iron/kitchen_coldroom,
/area/station/service/kitchen/coldroom)
"G" = (
/obj/machinery/atmospherics/pipe/smart/manifold4w/supply/hidden/layer4,
/obj/machinery/atmospherics/pipe/smart/manifold4w/scrubbers/hidden/layer2,
/obj/machinery/power/apc/auto_name/directional/north,
/obj/structure/cable,
/obj/structure/disposalpipe/segment{
	dir = 4
	},
/obj/effect/turf_decal/siding/white,
/turf/open/floor/iron/kitchen_coldroom/freezerfloor,
/area/station/service/kitchen/coldroom)
"H" = (
/obj/structure/sink/kitchen/directional/west,
/mob/living/basic/goat/pete,
/turf/open/floor/iron/kitchen_coldroom/freezerfloor,
/area/station/service/kitchen/coldroom)
"O" = (
/turf/template_noop,
/area/template_noop)
"V" = (
/obj/structure/kitchenspike,
/obj/item/radio/intercom/directional/east,
/obj/effect/turf_decal/tile/dark_green/opposingcorners,
/obj/effect/turf_decal/tile/dark_blue/opposingcorners{
	dir = 1
	},
/turf/open/floor/iron/kitchen_coldroom,
/area/station/service/kitchen/coldroom)
"X" = (
/obj/machinery/door/window/left/directional/east{
	name = "Kitchen Delivery";
	req_access = list("kitchen")
	},
/obj/effect/mapping_helpers/airalarm/tlv_cold_room,
/obj/machinery/airalarm/directional/north,
/obj/machinery/atmospherics/pipe/smart/manifold4w/scrubbers/hidden/layer2,
/obj/structure/disposalpipe/segment{
	dir = 4
	},
/obj/effect/turf_decal/siding/white,
/turf/open/floor/iron/kitchen_coldroom/freezerfloor,
/area/station/service/kitchen/coldroom)

(1,1,1) = {"
O
w
F
a
"}
(2,1,1) = {"
s
o
h
f
"}
(3,1,1) = {"
O
H
q
y
"}
(4,1,1) = {"
O
O
G
r
"}
(5,1,1) = {"
O
O
b
v
"}
(6,1,1) = {"
O
O
X
V
"}
