//MAP CONVERTED BY dmm2tgm.py THIS HEADER COMMENT PREVENTS RECONVERSION, DO NOT REMOVE
"a" = (
/obj/machinery/firealarm/directional/east,
/obj/structure/table/glass,
/obj/machinery/fax{
	fax_name = "Bridge";
	name = "Bridge Fax Machine"
	},
/turf/open/floor/iron/dark,
/area/station/command/bridge)

(1,1,1) = {"
a
"}
