//MAP CONVERTED BY dmm2tgm.py THIS HEADER COMMENT PREVENTS RECONVERSION, DO NOT REMOVE
"a" = (
/turf/template_noop,
/area/template_noop)
"y" = (
/obj/structure/cable,
/obj/structure/disposalpipe/segment,
/obj/effect/turf_decal/trimline/dark_blue/filled/warning{
	dir = 8
	},
/obj/machinery/atmospherics/pipe/smart/manifold4w/scrubbers/hidden/layer2,
/obj/machinery/atmospherics/pipe/smart/manifold4w/supply/hidden/layer4,
/obj/effect/landmark/start/explorer,
/turf/open/floor/iron,
/area/station/command/gateway)
"C" = (
/obj/machinery/atmospherics/components/unary/vent_pump/on/layer4{
	dir = 4
	},
/obj/effect/landmark/start/explorer,
/turf/open/floor/iron,
/area/station/command/gateway)
"N" = (
/obj/structure/cable,
/obj/structure/disposalpipe/segment,
/obj/machinery/atmospherics/pipe/smart/manifold4w/scrubbers/hidden/layer2,
/obj/effect/landmark/start/explorer,
/turf/open/floor/iron,
/area/station/command/gateway)

(1,1,1) = {"
a
C
a
a
a
"}
(2,1,1) = {"
N
a
a
a
y
"}
