//MAP CONVERTED BY dmm2tgm.py THIS HEADER COMMENT PREVENTS RECONVERSION, DO NOT REMOVE
"a" = (
/turf/open/floor/mineral/titanium,
/area/shuttle/black_mesa/elevator3)
"o" = (
/obj/machinery/computer/shuttle/black_mesa/lambda{
	dir = 8
	},
/turf/open/floor/mineral/titanium,
/area/shuttle/black_mesa/elevator3)
"T" = (
/obj/docking_port/mobile/elevator{
	dir = 2;
	shuttle_id = "blackmesa_lambda";
	name = "lambda core elevator"
	},
/turf/open/floor/mineral/titanium,
/area/shuttle/black_mesa/elevator3)

(1,1,1) = {"
a
a
a
"}
(2,1,1) = {"
T
a
a
"}
(3,1,1) = {"
a
o
a
"}
