//MAP CONVERTED BY dmm2tgm.py THIS HEADER COMMENT PREVENTS RECONVERSION, DO NOT REMOVE
"a" = (
/turf/open/floor/iron/white/smooth_large,
/area/shuttle/black_mesa/elevator1)
"r" = (
/obj/machinery/computer/shuttle/black_mesa/sci{
	dir = 4;
	name = "Elevator Control"
	},
/turf/open/floor/iron/white/smooth_large,
/area/shuttle/black_mesa/elevator1)
"y" = (
/obj/docking_port/mobile/elevator{
	dir = 2;
	shuttle_id = "blackmesa_sci";
	name = "sector c elevator"
	},
/turf/open/floor/iron/white/smooth_large,
/area/shuttle/black_mesa/elevator1)

(1,1,1) = {"
a
a
a
r
"}
(2,1,1) = {"
y
a
a
a
"}
(3,1,1) = {"
a
a
a
a
"}
(4,1,1) = {"
a
a
a
a
"}
