//MAP CONVERTED BY dmm2tgm.py THIS HEADER COMMENT PREVENTS RECONVERSION, DO NOT REMOVE
"a" = (
/turf/open/floor/mineral/titanium,
/area/shuttle/black_mesa/elevator2)
"g" = (
/obj/docking_port/mobile/elevator{
	dir = 4;
	shuttle_id = "blackmesa_freighter";
	name = "freighter elevator"
	},
/turf/open/floor/mineral/titanium,
/area/shuttle/black_mesa/elevator2)
"O" = (
/obj/machinery/computer/shuttle/black_mesa/freighter{
	dir = 8
	},
/turf/open/floor/mineral/titanium,
/area/shuttle/black_mesa/elevator2)

(1,1,1) = {"
a
a
g
a
a
"}
(2,1,1) = {"
a
a
a
a
a
"}
(3,1,1) = {"
a
a
a
a
a
"}
(4,1,1) = {"
a
a
a
a
a
"}
(5,1,1) = {"
a
a
O
a
a
"}
