//MAP CONVERTED BY dmm2tgm.py THIS HEADER COMMENT PREVENTS RECONVERSION, DO NOT REMOVE
"a" = (
/obj/effect/turf_decal/siding/dark/corner,
/obj/effect/turf_decal/trimline/dark_blue/filled/corner,
/obj/effect/turf_decal/tile/dark_blue/anticorner/contrasted{
	dir = 1
	},
/obj/item/kirbyplants/organic/plant22,
/obj/effect/turf_decal/trimline/dark/corner{
	dir = 8
	},
/turf/open/floor/iron/dark,
/area/station/command)
"d" = (
/obj/effect/turf_decal/trimline/dark_blue/filled/line{
	dir = 1
	},
/obj/effect/turf_decal/tile/dark_blue/half/contrasted,
/obj/effect/turf_decal/siding/dark{
	dir = 1
	},
/obj/structure/chair/sofa/bench/solo{
	dir = 1
	},
/turf/open/floor/iron/dark,
/area/station/command)
"f" = (
/obj/effect/spawner/structure/window/reinforced,
/obj/structure/cable,
/turf/open/floor/plating,
/area/station/command)
"g" = (
/obj/structure/stairs/south{
	color = "#3d3e42"
	},
/turf/open/floor/iron/dark,
/area/station/command)
"l" = (
/turf/open/floor/iron/dark,
/area/station/command)
"n" = (
/obj/effect/turf_decal/siding/dark/corner{
	dir = 8
	},
/obj/effect/turf_decal/trimline/dark_blue/filled/corner{
	dir = 8
	},
/obj/effect/turf_decal/tile/dark_blue/anticorner/contrasted{
	dir = 4
	},
/obj/item/kirbyplants/organic/plant22,
/obj/effect/turf_decal/trimline/dark/corner,
/turf/open/floor/iron/dark,
/area/station/command)
"p" = (
/obj/effect/turf_decal/siding/dark,
/obj/effect/turf_decal/trimline/dark_blue/filled/line,
/obj/effect/turf_decal/tile/dark_blue/half/contrasted{
	dir = 1
	},
/obj/structure/sign/directions/upload/directional/north{
	pixel_y = 29;
	dir = 4
	},
/obj/structure/sign/directions/vault/directional/north{
	pixel_y = 37
	},
/turf/open/floor/iron/dark,
/area/station/command)
"v" = (
/turf/closed/wall/r_wall,
/area/station/command)
"F" = (
/obj/effect/turf_decal/trimline/dark_blue/filled/line{
	dir = 1
	},
/obj/effect/turf_decal/tile/dark_blue/half/contrasted,
/obj/effect/turf_decal/siding/dark{
	dir = 1
	},
/turf/open/floor/iron/dark,
/area/station/command)
"W" = (
/obj/machinery/camera/autoname/directional/west,
/turf/open/floor/iron/dark,
/area/station/command)
"X" = (
/obj/structure/stairs/south{
	color = "#3d3e42"
	},
/obj/machinery/light/directional/south,
/turf/open/floor/iron/dark,
/area/station/command)

(1,1,1) = {"
d
v
v
v
v
f
"}
(2,1,1) = {"
F
W
g
g
v
a
"}
(3,1,1) = {"
F
l
g
X
v
p
"}
(4,1,1) = {"
F
l
g
g
v
n
"}
(5,1,1) = {"
d
v
v
v
v
f
"}
