//MAP CONVERTED BY dmm2tgm.py THIS HEADER COMMENT PREVENTS RECONVERSION, DO NOT REMOVE
"a" = (
/obj/effect/turf_decal/tile/dark_blue/half/contrasted{
	dir = 1
	},
/obj/effect/turf_decal/siding/dark,
/obj/effect/turf_decal/trimline/dark_blue/filled/line,
/obj/item/kirbyplants/organic/plant22,
/obj/item/kirbyplants/organic/plant22,
/turf/open/floor/iron/dark,
/area/station/hallway/secondary/command)
"e" = (
/turf/closed/wall/r_wall,
/area/station/hallway/secondary/command)
"f" = (
/turf/closed/wall/r_wall,
/area/station/ai_monitored/command/storage/eva)
"g" = (
/obj/effect/turf_decal/tile/dark_blue/half/contrasted{
	dir = 1
	},
/obj/effect/turf_decal/siding/dark,
/obj/effect/turf_decal/trimline/dark_blue/filled/line,
/turf/open/floor/iron/dark,
/area/station/hallway/secondary/command)
"j" = (
/obj/effect/turf_decal/tile/dark_blue/anticorner/contrasted{
	dir = 4
	},
/obj/effect/turf_decal/siding/dark/corner{
	dir = 8
	},
/obj/effect/turf_decal/trimline/dark_blue/filled/corner{
	dir = 8
	},
/obj/item/kirbyplants/organic/plant22,
/obj/effect/turf_decal/stripes/corner,
/obj/machinery/airalarm/directional/east,
/turf/open/floor/iron/dark,
/area/station/hallway/secondary/command)
"q" = (
/obj/machinery/camera/autoname/directional/west{
	dir = 10
	},
/turf/open/floor/iron/dark/textured_large,
/area/station/hallway/secondary/command)
"w" = (
/obj/effect/spawner/structure/window/reinforced,
/turf/open/floor/plating,
/area/station/hallway/secondary/command)
"D" = (
/turf/open/floor/iron/dark/textured_large,
/area/station/hallway/secondary/command)
"X" = (
/turf/open/openspace,
/area/station/hallway/secondary/command)
"Y" = (
/obj/structure/chair/sofa/corp/left,
/obj/effect/turf_decal/tile/dark_blue/half/contrasted{
	dir = 1
	},
/obj/effect/turf_decal/siding/dark,
/obj/effect/turf_decal/trimline/dark_blue/filled/line,
/obj/effect/landmark/start/hangover,
/obj/structure/sign/directions/upload/directional/north{
	pixel_y = 24;
	dir = 9
	},
/obj/structure/sign/directions/command/directional/north{
	dir = 9
	},
/obj/structure/sign/directions/vault/directional/north{
	pixel_y = 40;
	dir = 9
	},
/turf/open/floor/iron/dark,
/area/station/hallway/secondary/command)

(1,1,1) = {"
e
e
e
e
Y
"}
(2,1,1) = {"
e
X
X
q
a
"}
(3,1,1) = {"
w
X
X
D
g
"}
(4,1,1) = {"
e
X
X
D
j
"}
(5,1,1) = {"
e
e
e
f
f
"}
