//MAP CONVERTED BY dmm2tgm.py THIS HEADER COMMENT PREVENTS RECONVERSION, DO NOT REMOVE
"a" = (
/obj/effect/landmark/thunderdome/one,
/obj/effect/turf_decal/tile/neutral/fourcorners,
/obj/effect/light_emitter/thunderdome,
/turf/open/floor/iron,
/area/template_noop)
"b" = (
/obj/machinery/recharger{
	pixel_y = 4
	},
/obj/effect/landmark/thunderdome/two,
/obj/effect/turf_decal/delivery,
/obj/effect/light_emitter/thunderdome,
/turf/open/floor/iron,
/area/template_noop)
"c" = (
/obj/effect/landmark/thunderdome/one,
/obj/effect/turf_decal/stripes/line{
	dir = 9
	},
/obj/effect/light_emitter/thunderdome,
/turf/open/floor/iron,
/area/template_noop)
"d" = (
/obj/effect/landmark/thunderdome/one,
/obj/effect/turf_decal/stripes/line{
	dir = 6
	},
/obj/effect/light_emitter/thunderdome,
/turf/open/floor/iron,
/area/template_noop)
"e" = (
/obj/effect/landmark/thunderdome/two,
/obj/effect/turf_decal/tile/neutral/fourcorners,
/obj/effect/light_emitter/thunderdome,
/turf/open/floor/iron,
/area/template_noop)
"f" = (
/obj/effect/landmark/thunderdome/two,
/obj/effect/turf_decal/stripes/line{
	dir = 5
	},
/obj/effect/light_emitter/thunderdome,
/turf/open/floor/iron,
/area/template_noop)
"g" = (
/obj/effect/turf_decal/tile/red{
	dir = 8
	},
/obj/effect/light_emitter/thunderdome,
/turf/open/floor/iron,
/area/template_noop)
"h" = (
/obj/structure/rack,
/obj/item/clothing/under/color/red,
/obj/item/clothing/shoes/sneakers/brown,
/obj/item/clothing/suit/armor/vest,
/obj/item/clothing/head/helmet/swat,
/obj/item/gun/energy/laser,
/obj/effect/turf_decal/stripes/line{
	dir = 1
	},
/obj/effect/light_emitter/thunderdome,
/turf/open/floor/iron,
/area/template_noop)
"i" = (
/obj/machinery/recharger{
	pixel_y = 4
	},
/obj/effect/landmark/thunderdome/one,
/obj/effect/turf_decal/delivery,
/obj/effect/light_emitter/thunderdome,
/turf/open/floor/iron,
/area/template_noop)
"j" = (
/obj/effect/turf_decal/tile/red{
	dir = 1
	},
/obj/effect/light_emitter/thunderdome,
/turf/open/floor/iron,
/area/template_noop)
"k" = (
/obj/effect/turf_decal/tile/green{
	dir = 4
	},
/obj/effect/light_emitter/thunderdome,
/turf/open/floor/iron,
/area/template_noop)
"l" = (
/turf/open/floor/circuit/green,
/area/template_noop)
"m" = (
/obj/effect/landmark/thunderdome/two,
/obj/effect/turf_decal/stripes/line{
	dir = 6
	},
/obj/effect/light_emitter/thunderdome,
/turf/open/floor/iron,
/area/template_noop)
"n" = (
/obj/effect/light_emitter/thunderdome,
/turf/closed/indestructible/fakeglass,
/area/template_noop)
"o" = (
/obj/machinery/door/poddoor{
	id = "thunderdome";
	name = "Thunderdome Blast Door"
	},
/obj/effect/turf_decal/loading_area{
	dir = 4
	},
/obj/effect/light_emitter/thunderdome,
/turf/open/floor/iron,
/area/template_noop)
"p" = (
/obj/effect/landmark/thunderdome/one,
/obj/effect/turf_decal/stripes/line,
/obj/effect/light_emitter/thunderdome,
/turf/open/floor/iron,
/area/template_noop)
"q" = (
/obj/effect/landmark/thunderdome/one,
/obj/effect/turf_decal/stripes/line{
	dir = 1
	},
/obj/effect/light_emitter/thunderdome,
/turf/open/floor/iron,
/area/template_noop)
"r" = (
/obj/effect/turf_decal/delivery,
/obj/effect/light_emitter/thunderdome,
/turf/open/floor/iron,
/area/template_noop)
"s" = (
/obj/effect/landmark/thunderdome/two,
/obj/effect/turf_decal/stripes/line{
	dir = 9
	},
/obj/effect/light_emitter/thunderdome,
/turf/open/floor/iron,
/area/template_noop)
"t" = (
/obj/effect/landmark/thunderdome/one,
/obj/effect/turf_decal/stripes/line{
	dir = 5
	},
/obj/effect/light_emitter/thunderdome,
/turf/open/floor/iron,
/area/template_noop)
"u" = (
/obj/effect/turf_decal/tile/red/half/contrasted{
	dir = 8
	},
/obj/effect/light_emitter/thunderdome,
/turf/open/floor/iron,
/area/template_noop)
"v" = (
/turf/template_noop,
/area/template_noop)
"w" = (
/obj/machinery/door/poddoor{
	id = "thunderdome";
	name = "Thunderdome Blast Door"
	},
/obj/effect/turf_decal/loading_area{
	dir = 8
	},
/obj/effect/light_emitter/thunderdome,
/turf/open/floor/iron,
/area/template_noop)
"x" = (
/obj/effect/turf_decal/loading_area{
	dir = 4
	},
/obj/effect/light_emitter/thunderdome,
/turf/open/floor/iron,
/area/template_noop)
"y" = (
/obj/effect/turf_decal/tile/green/half/contrasted{
	dir = 4
	},
/obj/effect/light_emitter/thunderdome,
/turf/open/floor/iron,
/area/template_noop)
"z" = (
/turf/closed/indestructible/riveted,
/area/template_noop)
"A" = (
/obj/structure/rack,
/obj/item/clothing/under/color/red,
/obj/item/clothing/shoes/sneakers/brown,
/obj/item/clothing/suit/armor/tdome/red,
/obj/item/clothing/head/helmet/thunderdome,
/obj/item/melee/baton/security/loaded,
/obj/item/melee/energy/sword/saber/red,
/obj/effect/turf_decal/stripes/line,
/obj/effect/light_emitter/thunderdome,
/turf/open/floor/iron,
/area/template_noop)
"B" = (
/obj/effect/landmark/thunderdome/two,
/obj/effect/turf_decal/stripes/line{
	dir = 10
	},
/obj/effect/light_emitter/thunderdome,
/turf/open/floor/iron,
/area/template_noop)
"C" = (
/obj/effect/light_emitter/thunderdome,
/turf/open/floor/iron,
/area/template_noop)
"D" = (
/obj/effect/landmark/thunderdome/two,
/obj/effect/turf_decal/stripes/line{
	dir = 1
	},
/obj/effect/light_emitter/thunderdome,
/turf/open/floor/iron,
/area/template_noop)
"E" = (
/obj/effect/landmark/thunderdome/one,
/obj/effect/turf_decal/stripes/line{
	dir = 4
	},
/obj/effect/light_emitter/thunderdome,
/turf/open/floor/iron,
/area/template_noop)
"F" = (
/obj/machinery/igniter/on,
/obj/effect/turf_decal/delivery,
/obj/effect/light_emitter/thunderdome,
/turf/open/floor/iron,
/area/template_noop)
"G" = (
/obj/effect/turf_decal/tile/neutral/half/contrasted{
	dir = 4
	},
/obj/effect/light_emitter/thunderdome,
/turf/open/floor/iron,
/area/template_noop)
"H" = (
/obj/effect/landmark/thunderdome/two,
/obj/effect/turf_decal/stripes/line,
/obj/effect/light_emitter/thunderdome,
/turf/open/floor/iron,
/area/template_noop)
"I" = (
/obj/effect/turf_decal/loading_area,
/obj/machinery/door/poddoor{
	id = "thunderdomegen";
	name = "General Supply"
	},
/obj/effect/light_emitter/thunderdome,
/turf/open/floor/iron,
/area/template_noop)
"J" = (
/obj/machinery/camera/directional/north{
	c_tag = "Green Team";
	network = list("thunder");
	pixel_x = 12;
	pixel_y = -10;
	resistance_flags = 64
	},
/obj/effect/landmark/thunderdome/one,
/obj/effect/turf_decal/tile/neutral/fourcorners,
/obj/effect/light_emitter/thunderdome,
/turf/open/floor/iron,
/area/template_noop)
"K" = (
/obj/effect/turf_decal/tile/neutral/half/contrasted{
	dir = 8
	},
/obj/effect/light_emitter/thunderdome,
/turf/open/floor/iron,
/area/template_noop)
"L" = (
/obj/effect/turf_decal/bot,
/obj/effect/light_emitter/thunderdome,
/turf/open/floor/iron,
/area/template_noop)
"M" = (
/obj/structure/rack,
/obj/item/clothing/under/color/green,
/obj/item/clothing/shoes/sneakers/brown,
/obj/item/clothing/suit/armor/vest,
/obj/item/clothing/head/helmet/swat,
/obj/item/gun/energy/laser,
/obj/effect/turf_decal/stripes/line{
	dir = 1
	},
/obj/effect/light_emitter/thunderdome,
/turf/open/floor/iron,
/area/template_noop)
"N" = (
/obj/effect/landmark/thunderdome/two,
/obj/effect/turf_decal/stripes/line{
	dir = 8
	},
/obj/effect/light_emitter/thunderdome,
/turf/open/floor/iron,
/area/template_noop)
"O" = (
/obj/structure/rack,
/obj/item/clothing/under/color/green,
/obj/item/clothing/shoes/sneakers/brown,
/obj/item/clothing/suit/armor/tdome/green,
/obj/item/clothing/head/helmet/thunderdome,
/obj/item/melee/baton/security/loaded,
/obj/item/melee/energy/sword/saber/green,
/obj/effect/turf_decal/stripes/line,
/obj/effect/light_emitter/thunderdome,
/turf/open/floor/iron,
/area/template_noop)
"P" = (
/obj/effect/landmark/thunderdome/one,
/obj/effect/turf_decal/stripes/line{
	dir = 10
	},
/obj/effect/light_emitter/thunderdome,
/turf/open/floor/iron,
/area/template_noop)
"Q" = (
/obj/effect/landmark/thunderdome/two,
/obj/effect/turf_decal/stripes/line{
	dir = 4
	},
/obj/effect/light_emitter/thunderdome,
/turf/open/floor/iron,
/area/template_noop)
"S" = (
/obj/machinery/flasher{
	id = "tdomeflash";
	name = "Thunderdome Flash"
	},
/turf/open/floor/circuit/green,
/area/template_noop)
"T" = (
/obj/effect/landmark/thunderdome/one,
/obj/effect/turf_decal/stripes/line{
	dir = 8
	},
/obj/effect/light_emitter/thunderdome,
/turf/open/floor/iron,
/area/template_noop)
"U" = (
/obj/effect/turf_decal/tile/neutral/fourcorners,
/obj/effect/light_emitter/thunderdome,
/turf/open/floor/iron,
/area/template_noop)
"V" = (
/obj/effect/turf_decal/loading_area{
	dir = 8
	},
/obj/effect/light_emitter/thunderdome,
/turf/open/floor/iron,
/area/template_noop)
"W" = (
/obj/machinery/camera/motion/thunderdome{
	pixel_x = 10
	},
/turf/open/floor/circuit/green,
/area/template_noop)
"X" = (
/obj/effect/turf_decal/tile/green,
/obj/effect/light_emitter/thunderdome,
/turf/open/floor/iron,
/area/template_noop)
"Y" = (
/obj/machinery/door/poddoor{
	id = "thunderdomehea";
	name = "Heavy Supply"
	},
/obj/effect/turf_decal/loading_area,
/obj/effect/light_emitter/thunderdome,
/turf/open/floor/iron,
/area/template_noop)
"Z" = (
/obj/machinery/camera/directional/north{
	c_tag = "Red Team";
	network = list("thunder");
	pixel_x = 11;
	pixel_y = -9;
	resistance_flags = 64
	},
/obj/effect/landmark/thunderdome/two,
/obj/effect/turf_decal/tile/neutral/fourcorners,
/obj/effect/light_emitter/thunderdome,
/turf/open/floor/iron,
/area/template_noop)

(1,1,1) = {"
v
v
v
v
v
v
v
v
v
v
v
v
"}
(2,1,1) = {"
v
v
v
v
v
v
v
v
v
v
v
v
"}
(3,1,1) = {"
z
z
z
z
z
z
z
z
z
z
z
z
"}
(4,1,1) = {"
z
A
I
s
N
N
N
N
B
Y
h
z
"}
(5,1,1) = {"
z
A
I
D
b
e
e
b
H
Y
h
z
"}
(6,1,1) = {"
z
A
I
D
e
Z
e
e
H
Y
h
z
"}
(7,1,1) = {"
z
A
I
D
b
e
e
b
H
Y
h
z
"}
(8,1,1) = {"
z
A
I
f
Q
Q
Q
Q
m
Y
h
z
"}
(9,1,1) = {"
z
z
z
o
o
o
o
o
o
z
z
z
"}
(10,1,1) = {"
v
n
F
u
j
x
x
g
u
F
n
v
"}
(11,1,1) = {"
v
n
C
C
C
C
C
C
C
C
n
v
"}
(12,1,1) = {"
v
n
L
r
r
r
r
r
r
L
n
v
"}
(13,1,1) = {"
v
n
C
G
G
G
G
G
G
C
n
v
"}
(14,1,1) = {"
v
n
C
U
U
U
U
U
U
C
n
v
"}
(15,1,1) = {"
v
n
C
U
U
U
U
U
U
C
n
v
"}
(16,1,1) = {"
v
n
C
U
U
l
l
U
U
C
n
v
"}
(17,1,1) = {"
v
n
C
U
U
S
W
U
U
C
n
v
"}
(18,1,1) = {"
v
n
C
U
U
l
l
U
U
C
n
v
"}
(19,1,1) = {"
v
n
C
U
U
U
U
U
U
C
n
v
"}
(20,1,1) = {"
v
n
C
U
U
U
U
U
U
C
n
v
"}
(21,1,1) = {"
v
n
C
K
K
K
K
K
K
C
n
v
"}
(22,1,1) = {"
v
n
L
r
r
r
r
r
r
L
n
v
"}
(23,1,1) = {"
v
n
C
C
C
C
C
C
C
C
n
v
"}
(24,1,1) = {"
v
n
F
y
k
V
V
X
y
F
n
v
"}
(25,1,1) = {"
z
z
z
w
w
w
w
w
w
z
z
z
"}
(26,1,1) = {"
z
O
I
c
T
T
T
T
P
Y
M
z
"}
(27,1,1) = {"
z
O
I
q
i
a
a
i
p
Y
M
z
"}
(28,1,1) = {"
z
O
I
q
a
J
a
a
p
Y
M
z
"}
(29,1,1) = {"
z
O
I
q
i
a
a
i
p
Y
M
z
"}
(30,1,1) = {"
z
O
I
t
E
E
E
E
d
Y
M
z
"}
(31,1,1) = {"
z
z
z
z
z
z
z
z
z
z
z
z
"}
(32,1,1) = {"
v
v
v
v
v
v
v
v
v
v
v
v
"}
(33,1,1) = {"
v
v
v
v
v
v
v
v
v
v
v
v
"}
