//MAP CONVERTED BY dmm2tgm.py THIS HEADER COMMENT PREVENTS RECONVERSION, DO NOT REMOVE
"a" = (
/turf/template_noop,
/area/template_noop)
"c" = (
/obj/effect/turf_decal/stripes/line{
	dir = 9
	},
/obj/structure/cable,
/obj/machinery/atmospherics/pipe/smart/manifold4w/supply/hidden/layer4,
/obj/machinery/atmospherics/pipe/smart/manifold4w/scrubbers/hidden/layer2,
/obj/effect/landmark/start/explorer,
/turf/open/floor/iron/dark/small,
/area/station/ai_monitored/command/storage/eva)
"w" = (
/obj/effect/turf_decal/stripes/line{
	dir = 5
	},
/obj/effect/landmark/start/explorer,
/turf/open/floor/iron/dark/small,
/area/station/ai_monitored/command/storage/eva)
"L" = (
/obj/effect/turf_decal/stripes/line{
	dir = 10
	},
/obj/structure/cable,
/obj/machinery/atmospherics/pipe/smart/manifold4w/supply/hidden/layer4,
/obj/machinery/atmospherics/pipe/smart/manifold4w/scrubbers/hidden/layer2,
/obj/effect/landmark/start/explorer,
/turf/open/floor/iron/dark/small,
/area/station/ai_monitored/command/storage/eva)
"S" = (
/obj/effect/turf_decal/stripes/line{
	dir = 6
	},
/obj/structure/cable,
/obj/machinery/atmospherics/pipe/smart/manifold4w/scrubbers/hidden/layer2,
/obj/effect/landmark/start/explorer,
/turf/open/floor/iron/dark/small,
/area/station/ai_monitored/command/storage/eva)

(1,1,1) = {"
c
a
L
"}
(2,1,1) = {"
a
a
a
"}
(3,1,1) = {"
w
a
S
"}
