//MAP CONVERTED BY dmm2tgm.py THIS HEADER COMMENT PREVENTS RECONVERSION, DO NOT REMOVE
"a" = (
/obj/structure/table/reinforced/plastitaniumglass,
/obj/machinery/fax{
	fax_name = "Bridge";
	name = "Bridge Fax Machine"
	},
/turf/open/floor/iron,
/area/station/command/bridge)

(1,1,1) = {"
a
"}
