//MAP CONVERTED BY dmm2tgm.py THIS HEADER COMMENT PREVENTS RECONVERSION, DO NOT REMOVE
"a" = (
/obj/effect/turf_decal/siding/wood{
	dir = 4
	},
/obj/machinery/door/window/left/directional/east{
	name = "Captain's Desk Door";
	req_access = list("captain")
	},
/obj/machinery/keycard_auth/wall_mounted/directional/south{
	pixel_x = 0;
	pixel_y = -32
	},
/obj/machinery/atmospherics/components/unary/vent_pump/on/layer4{
	dir = 4
	},
/obj/structure/phone_base/captain{
	dir = 1;
	pixel_x = 0;
	pixel_y = -29
	},
/turf/open/floor/wood/large,
/area/station/command/heads_quarters/captain)

(1,1,1) = {"
a
"}
