//MAP CONVERTED BY dmm2tgm.py THIS HEADER COMMENT PREVENTS RECONVERSION, DO NOT REMOVE
"az" = (
/obj/effect/turf_decal/siding/dark{
	dir = 10
	},
/turf/open/floor/iron/dark/small,
/area/station/cargo/exploration_office)
"bE" = (
/obj/structure/cable,
/obj/machinery/atmospherics/pipe/smart/manifold4w/supply/hidden/layer4,
/obj/machinery/atmospherics/pipe/smart/manifold4w/scrubbers/hidden/layer2,
/turf/open/floor/iron/dark,
/area/station/cargo/exploration_office)
"cs" = (
/obj/machinery/suit_storage_unit/explorer,
/obj/effect/turf_decal/stripes/line,
/obj/machinery/camera/directional/east{
	c_tag = "Supply - Exploration Office";
	dir = 5
	},
/turf/open/floor/iron/dark/smooth_edge,
/area/station/cargo/exploration_office)
"cx" = (
/obj/machinery/suit_storage_unit/explorer,
/obj/effect/turf_decal/stripes/line,
/obj/machinery/light/directional/south,
/turf/open/floor/iron/dark/smooth_edge,
/area/station/cargo/exploration_office)
"dn" = (
/obj/item/multitool{
	pixel_x = -7;
	pixel_y = 2
	},
/obj/item/stack/impure_telecrystal{
	pixel_x = -6;
	pixel_y = -2
	},
/obj/item/stack/rods/twentyfive{
	pixel_x = 4
	},
/obj/structure/closet/generic/wall/empty{
	pixel_y = 26;
	pixel_x = -4
	},
/obj/machinery/firealarm/directional/north{
	pixel_x = 10;
	pixel_y = 18
	},
/turf/open/floor/iron/dark,
/area/station/cargo/exploration_office)
"ef" = (
/obj/structure/table/reinforced,
/obj/machinery/cell_charger,
/obj/effect/turf_decal/stripes/line{
	dir = 8
	},
/turf/open/floor/iron/dark/smooth_edge{
	dir = 8
	},
/area/station/cargo/exploration_office)
"eR" = (
/obj/effect/turf_decal/stripes/line{
	dir = 5
	},
/turf/open/floor/engine,
/area/station/cargo/exploration_office)
"fa" = (
/obj/structure/closet/toolcloset,
/obj/item/storage/box/nri_flares,
/obj/effect/turf_decal/stripes/line,
/turf/open/floor/iron/dark/smooth_edge,
/area/station/cargo/exploration_office)
"hf" = (
/obj/structure/lattice/catwalk,
/obj/structure/railing{
	dir = 8
	},
/obj/structure/railing{
	dir = 4
	},
/turf/open/space/basic,
/area/space/nearstation)
"hk" = (
/obj/effect/landmark/carpspawn,
/turf/open/space/basic,
/area/space)
"iP" = (
/obj/structure/lattice/catwalk,
/turf/open/space/basic,
/area/space/nearstation)
"jq" = (
/obj/structure/railing{
	dir = 8
	},
/obj/structure/marker_beacon/indigo{
	pixel_x = 14;
	pixel_y = -12
	},
/obj/structure/lattice/catwalk,
/obj/structure/railing/corner{
	dir = 4
	},
/turf/open/space/basic,
/area/space/nearstation)
"kK" = (
/obj/item/toy/cattoy,
/obj/machinery/atmospherics/pipe/smart/manifold4w/scrubbers/hidden/layer2,
/turf/open/floor/iron/dark,
/area/station/cargo/exploration_office)
"lD" = (
/obj/structure/cable,
/obj/effect/landmark/start/explorer,
/obj/machinery/atmospherics/pipe/smart/manifold4w/supply/hidden/layer4,
/obj/machinery/atmospherics/pipe/smart/manifold4w/scrubbers/hidden/layer2,
/turf/open/floor/iron/dark,
/area/station/cargo/exploration_office)
"mL" = (
/obj/structure/railing,
/obj/structure/marker_beacon/indigo{
	pixel_x = -12;
	pixel_y = 15
	},
/obj/structure/lattice/catwalk,
/turf/open/space/basic,
/area/space/nearstation)
"no" = (
/obj/machinery/atmospherics/pipe/smart/manifold4w/supply/hidden/layer4,
/obj/machinery/atmospherics/pipe/smart/manifold4w/scrubbers/hidden/layer2,
/turf/open/floor/iron,
/area/station/commons/orbital_lounge)
"nr" = (
/obj/structure/table/reinforced,
/obj/machinery/recharger{
	pixel_x = 3;
	pixel_y = 6
	},
/obj/item/storage/medkit/emergency{
	pixel_y = -10;
	pixel_x = -2
	},
/obj/effect/turf_decal/stripes/line{
	dir = 8
	},
/turf/open/floor/iron/dark/smooth_edge{
	dir = 8
	},
/area/station/cargo/exploration_office)
"on" = (
/obj/effect/turf_decal/stripes/box,
/obj/machinery/dive_anchor/stationary,
/turf/open/floor/engine,
/area/station/cargo/exploration_office)
"ou" = (
/turf/open/space/basic,
/area/space)
"pi" = (
/obj/structure/tank_dispenser/oxygen,
/obj/effect/turf_decal/stripes/line{
	dir = 8
	},
/obj/effect/decal/cleanable/cobweb,
/obj/machinery/light_switch/directional/north{
	pixel_x = 12;
	pixel_y = 20
	},
/obj/machinery/light/directional/west,
/turf/open/floor/iron/dark/smooth_edge{
	dir = 8
	},
/area/station/cargo/exploration_office)
"rK" = (
/obj/structure/closet/firecloset,
/obj/machinery/atmospherics/pipe/smart/manifold4w/supply/hidden/layer4,
/obj/structure/cable,
/obj/machinery/atmospherics/pipe/smart/manifold4w/scrubbers/hidden/layer2,
/turf/open/floor/iron,
/area/station/commons/orbital_lounge)
"rL" = (
/obj/effect/turf_decal/stripes/line,
/turf/open/floor/engine,
/area/station/cargo/exploration_office)
"sp" = (
/obj/machinery/dive_anchor,
/turf/open/space/basic,
/area/space/nearstation)
"sC" = (
/obj/effect/turf_decal/caution/stand_clear{
	dir = 4
	},
/obj/machinery/light/small/dim/directional/north,
/turf/open/floor/plating,
/area/station/commons/orbital_lounge)
"sR" = (
/obj/structure/chair/office{
	dir = 1
	},
/obj/effect/turf_decal/siding/dark{
	dir = 4
	},
/obj/effect/landmark/start/explorer,
/turf/open/floor/iron/dark/small,
/area/station/cargo/exploration_office)
"tk" = (
/obj/effect/turf_decal/stripes/line{
	dir = 4
	},
/turf/open/floor/engine,
/area/station/cargo/exploration_office)
"tZ" = (
/obj/effect/spawner/structure/window/reinforced,
/turf/open/floor/plating,
/area/station/cargo/exploration_office)
"uW" = (
/obj/structure/lattice/catwalk,
/obj/structure/marker_beacon/burgundy,
/turf/open/space/basic,
/area/space/nearstation)
"vU" = (
/obj/machinery/door/airlock/external/glass{
	name = "External Access";
	space_dir = 8
	},
/obj/effect/mapping_helpers/airlock/cyclelink_helper{
	dir = 4
	},
/obj/effect/turf_decal/stripes/line{
	dir = 8
	},
/obj/effect/turf_decal/stripes/line{
	dir = 4
	},
/turf/open/floor/plating,
/area/station/commons/orbital_lounge)
"AO" = (
/obj/effect/spawner/structure/window/reinforced,
/turf/open/floor/plating,
/area/station/commons/orbital_lounge)
"AR" = (
/obj/structure/railing{
	dir = 1
	},
/obj/structure/bed/dogbed{
	name = "Lem's bed";
	desc = "A comfy-looking cat bed. You can even strap your pet in, in case the gravity turns off."
	},
/mob/living/basic/pet/cat/space{
	name = "Lem";
	gender = "male";
	unique_pet = 1;
	desc = "He's kittened out for space exploration."
	},
/turf/open/floor/iron/dark,
/area/station/cargo/exploration_office)
"Bo" = (
/obj/structure/cable,
/obj/machinery/atmospherics/pipe/smart/manifold4w/scrubbers/hidden/layer2,
/turf/open/floor/iron/dark,
/area/station/cargo/exploration_office)
"Bs" = (
/turf/closed/wall,
/area/station/cargo/exploration_office)
"BO" = (
/obj/structure/lattice/catwalk,
/obj/structure/railing/corner/end{
	dir = 4
	},
/obj/structure/railing/corner/end/flip{
	dir = 8
	},
/turf/open/space/basic,
/area/space/nearstation)
"DX" = (
/turf/open/floor/iron/dark,
/area/station/cargo/exploration_office)
"En" = (
/turf/open/floor/iron,
/area/station/commons/orbital_lounge)
"Ev" = (
/obj/effect/turf_decal/stripes/line{
	dir = 1
	},
/obj/machinery/light/directional/north,
/turf/open/floor/engine,
/area/station/cargo/exploration_office)
"FT" = (
/obj/machinery/door/airlock/external/glass{
	name = "External Access";
	space_dir = 8
	},
/obj/effect/mapping_helpers/airlock/cyclelink_helper{
	dir = 8
	},
/obj/effect/turf_decal/stripes/line{
	dir = 8
	},
/obj/effect/turf_decal/stripes/line{
	dir = 4
	},
/turf/open/floor/plating,
/area/station/commons/orbital_lounge)
"Gd" = (
/obj/effect/turf_decal/stripes/line{
	dir = 6
	},
/turf/open/floor/engine,
/area/station/cargo/exploration_office)
"Ip" = (
/obj/machinery/atmospherics/pipe/smart/manifold4w/scrubbers/hidden/layer2,
/obj/structure/cable,
/turf/open/floor/iron/dark,
/area/station/cargo/exploration_office)
"Iq" = (
/obj/machinery/portable_atmospherics/canister/oxygen,
/obj/effect/turf_decal/stripes/line{
	dir = 8
	},
/obj/machinery/power/apc/auto_name/directional/south,
/obj/structure/cable,
/turf/open/floor/iron/dark/smooth_edge{
	dir = 8
	},
/area/station/cargo/exploration_office)
"IN" = (
/obj/structure/lattice,
/obj/structure/grille,
/turf/open/space/basic,
/area/space/nearstation)
"Jb" = (
/obj/machinery/door/airlock/mining{
	name = "Exploration Office"
	},
/obj/machinery/door/firedoor,
/obj/structure/cable,
/obj/effect/mapping_helpers/airlock/access/any/command/gateway,
/obj/machinery/atmospherics/pipe/smart/manifold4w/supply/hidden/layer4,
/obj/machinery/atmospherics/pipe/smart/manifold4w/scrubbers/hidden/layer2,
/turf/open/floor/iron/dark/side,
/area/station/cargo/exploration_office)
"KP" = (
/obj/structure/grille,
/turf/open/space/basic,
/area/space/nearstation)
"KS" = (
/obj/structure/lattice/catwalk,
/obj/structure/railing/corner,
/obj/structure/railing/corner/end,
/turf/open/space/basic,
/area/space/nearstation)
"KX" = (
/obj/machinery/computer/cargo/request,
/obj/structure/railing{
	dir = 1
	},
/obj/effect/turf_decal/siding/dark{
	dir = 5
	},
/turf/open/floor/iron/dark/small,
/area/station/cargo/exploration_office)
"Lb" = (
/obj/structure/railing/corner/end,
/obj/structure/railing/corner/end/flip{
	dir = 1
	},
/obj/structure/lattice/catwalk,
/turf/open/space/basic,
/area/space/nearstation)
"ME" = (
/obj/structure/lattice,
/turf/open/space/basic,
/area/space/nearstation)
"MF" = (
/obj/machinery/atmospherics/components/unary/vent_scrubber/on/layer2{
	dir = 8
	},
/obj/effect/landmark/start/explorer,
/turf/open/floor/iron/dark,
/area/station/cargo/exploration_office)
"MG" = (
/obj/structure/marker_beacon/indigo{
	pixel_x = -12;
	pixel_y = -12
	},
/obj/structure/lattice/catwalk,
/obj/structure/railing{
	dir = 1
	},
/turf/open/space/basic,
/area/space/nearstation)
"MQ" = (
/obj/structure/cable,
/obj/structure/sign/poster/official/safety_internals/directional/east,
/obj/machinery/atmospherics/pipe/smart/manifold4w/supply/hidden/layer4,
/obj/machinery/atmospherics/pipe/smart/manifold4w/scrubbers/hidden/layer2,
/obj/item/kirbyplants/random/fullysynthetic{
	pixel_x = 10;
	pixel_y = 16
	},
/turf/open/floor/iron,
/area/station/commons/orbital_lounge)
"Ni" = (
/obj/machinery/atmospherics/components/unary/vent_pump/on/layer4{
	dir = 8
	},
/turf/open/floor/iron/dark,
/area/station/cargo/exploration_office)
"Oj" = (
/obj/effect/turf_decal/stripes/line{
	dir = 8
	},
/turf/open/floor/engine,
/area/station/cargo/exploration_office)
"OE" = (
/obj/structure/closet/emcloset,
/obj/machinery/atmospherics/pipe/smart/manifold4w/supply/hidden/layer4,
/obj/structure/cable,
/obj/machinery/atmospherics/pipe/smart/manifold4w/scrubbers/hidden/layer2,
/turf/open/floor/iron,
/area/station/commons/orbital_lounge)
"OM" = (
/obj/structure/closet{
	anchored = 1
	},
/obj/item/storage/box/colonial_rations,
/obj/item/storage/box/colonial_rations,
/obj/item/storage/box/colonial_rations,
/obj/effect/spawner/random/food_or_drink/booze,
/obj/effect/spawner/random/food_or_drink/booze,
/obj/effect/turf_decal/stripes/line,
/turf/open/floor/iron/dark/smooth_edge,
/area/station/cargo/exploration_office)
"OS" = (
/turf/closed/wall,
/area/station/commons/orbital_lounge)
"Pe" = (
/obj/machinery/computer/anchor_controller,
/obj/structure/railing{
	dir = 1
	},
/obj/effect/turf_decal/siding/dark{
	dir = 9
	},
/turf/open/floor/iron/dark/small,
/area/station/cargo/exploration_office)
"SY" = (
/obj/structure/filingcabinet{
	pixel_x = 8
	},
/obj/item/camera,
/obj/item/camera_film,
/obj/item/cigarette/cigar/havana,
/obj/effect/turf_decal/siding/dark{
	dir = 6
	},
/obj/machinery/airalarm/directional/south,
/turf/open/floor/iron/dark/small,
/area/station/cargo/exploration_office)
"TA" = (
/obj/effect/turf_decal/stripes/line{
	dir = 9
	},
/turf/open/floor/engine,
/area/station/cargo/exploration_office)
"TO" = (
/obj/effect/spawner/random/engineering/tracking_beacon,
/turf/open/floor/iron/dark,
/area/station/cargo/exploration_office)
"Ub" = (
/obj/effect/turf_decal/siding/dark{
	dir = 8
	},
/turf/open/floor/iron/dark/small,
/area/station/cargo/exploration_office)
"UG" = (
/obj/effect/spawner/random/trash/graffiti{
	pixel_y = 32
	},
/obj/structure/lattice,
/turf/open/space/basic,
/area/space/nearstation)
"WI" = (
/obj/effect/turf_decal/stripes/line{
	dir = 10
	},
/turf/open/floor/engine,
/area/station/cargo/exploration_office)
"XI" = (
/obj/structure/railing{
	dir = 10
	},
/obj/structure/marker_beacon/indigo{
	pixel_x = 14;
	pixel_y = 15
	},
/obj/structure/lattice/catwalk,
/turf/open/space/basic,
/area/space/nearstation)
"YS" = (
/obj/structure/cable,
/obj/machinery/atmospherics/pipe/smart/manifold4w/supply/hidden/layer4,
/obj/machinery/atmospherics/pipe/smart/manifold4w/scrubbers/hidden/layer2,
/turf/open/floor/iron,
/area/station/commons/orbital_lounge)
"Zy" = (
/turf/template_noop,
/area/template_noop)
"ZI" = (
/obj/structure/railing{
	dir = 1
	},
/obj/structure/lattice/catwalk,
/turf/open/space/basic,
/area/space/nearstation)

(1,1,1) = {"
Zy
Zy
Zy
Zy
Zy
Zy
Zy
Zy
Zy
Zy
Zy
Zy
Zy
hk
"}
(2,1,1) = {"
Zy
Zy
Zy
Zy
Zy
Zy
Zy
Zy
Zy
Zy
Zy
Zy
Zy
Zy
"}
(3,1,1) = {"
Zy
Zy
Zy
Zy
iP
uW
ME
ME
ME
ME
ou
Zy
Zy
Zy
"}
(4,1,1) = {"
Zy
Zy
Zy
Zy
iP
KS
hf
jq
Lb
XI
ou
IN
Zy
Zy
"}
(5,1,1) = {"
Zy
Zy
Zy
OS
vU
OS
ou
ZI
sp
BO
ME
IN
Zy
Zy
"}
(6,1,1) = {"
Zy
Zy
Zy
OS
sC
AO
ou
MG
iP
mL
ou
IN
Zy
Zy
"}
(7,1,1) = {"
Zy
Zy
Zy
OS
FT
Bs
Bs
tZ
tZ
tZ
Bs
IN
Zy
Zy
"}
(8,1,1) = {"
no
Zy
Zy
En
En
Bs
pi
nr
ef
Iq
Bs
Bs
Zy
Zy
"}
(9,1,1) = {"
OE
rK
OE
MQ
YS
Jb
bE
lD
Bo
Ip
fa
Bs
ou
IN
"}
(10,1,1) = {"
OS
OS
OS
Bs
Bs
Bs
dn
Ni
TO
kK
cs
Bs
UG
IN
"}
(11,1,1) = {"
Zy
Zy
ME
Bs
TA
Oj
WI
AR
DX
MF
cx
Bs
ME
IN
"}
(12,1,1) = {"
Zy
Zy
ME
Bs
Ev
on
rL
Pe
Ub
az
OM
Bs
ou
IN
"}
(13,1,1) = {"
Zy
Zy
ME
Bs
eR
tk
Gd
KX
sR
SY
Bs
Bs
Zy
Zy
"}
(14,1,1) = {"
Zy
Zy
IN
Bs
Bs
Bs
Bs
tZ
tZ
tZ
Bs
Zy
Zy
Zy
"}
(15,1,1) = {"
Zy
Zy
Zy
Zy
KP
Zy
Zy
Zy
Zy
ME
Zy
Zy
Zy
Zy
"}
